date	item type	item name	artist	currency	item price	quantity	sub total	additional fan contribution	tax rate	seller tax	marketplace tax	shipping	ship from country name	transaction fee	fee type	item total	amount you received	assessed revenue share	collected revenue share	balance of revenue share	change to payout balance	payout balance	net amount	package	option	item url	catalog number	upc	isrc	country	country code	tax withholding
4/9/18 7:05 PM	album	EP	PatternShift	USD	10.0	1.0	10.0	0.0	NA	NA	NA	NA	NA	0.52	credit card	10.0	0.0	1.5	1.5	0.0	7.98	7.98	7.98	digital download	NA	https://patternshift.bandcamp.com/album/patternshift-ep	NA	NA	NA	United States	US	NA
4/10/18 2:07 PM	album	EP	PatternShift	USD	10.0	1.0	10.0	0.0	NA	NA	NA	NA	NA	0.52	credit card	10.0	0.0	1.5	1.5	0.0	7.98	15.96	7.98	digital download	NA	https://patternshift.bandcamp.com/album/patternshift-ep	NA	NA	NA	Hong Kong	HK	NA
4/10/18 8:08 PM	payout	NA	NA	USD	NA	NA	NA	NA	NA	NA	NA	NA	NA	0.08	transfer	7.98	7.9	NA	NA	NA	-7.98	7.98	NA	NA	NA	NA	NA	NA	NA	NA	NA	0.0
4/11/18 8:04 PM	payout	NA	NA	USD	NA	NA	NA	NA	NA	NA	NA	NA	NA	0.08	transfer	7.98	7.9	NA	NA	NA	-7.98	0.0	NA	NA	NA	NA	NA	NA	NA	NA	NA	0.0
4/14/18 12:48 AM	album	EP	PatternShift	USD	4.0	1.0	4.0	0.0	NA	NA	0.76	NA	NA	0.34	credit card	4.76	0.0	0.6	0.6	0.0	3.06	3.06	3.06	digital download	NA	https://patternshift.bandcamp.com/album/patternshift-ep	NA	NA	NA	Germany	DE	NA
4/15/18 8:07 PM	payout	NA	NA	USD	NA	NA	NA	NA	NA	NA	NA	NA	NA	0.03	transfer	3.06	3.03	NA	NA	NA	-3.06	0.0	NA	NA	NA	NA	NA	NA	NA	NA	NA	0.0
4/19/18 2:10 AM	album	EP	PatternShift	USD	15.0	1.0	15.0	0.0	NA	NA	NA	NA	NA	0.59	paypal	15.0	0.0	2.25	2.25	0.0	12.16	12.16	12.16	digital download	NA	https://patternshift.bandcamp.com/album/patternshift-ep	NA	NA	NA	United States	US	NA
4/20/18 8:04 PM	payout	NA	NA	USD	NA	NA	NA	NA	NA	NA	NA	NA	NA	0.12	transfer	12.16	12.04	NA	NA	NA	-12.16	0.0	NA	NA	NA	NA	NA	NA	NA	NA	NA	0.0
4/21/18 5:04 PM	album	EP	PatternShift	USD	10.0	1.0	10.0	0.0	NA	NA	NA	NA	NA	0.52	credit card	10.0	0.0	1.5	1.5	0.0	7.98	7.98	7.98	digital download	NA	https://patternshift.bandcamp.com/album/patternshift-ep	NA	NA	NA	United States	US	NA
4/22/18 8:20 PM	payout	NA	NA	USD	NA	NA	NA	NA	NA	NA	NA	NA	NA	0.08	transfer	7.98	7.9	NA	NA	NA	-7.98	0.0	NA	NA	NA	NA	NA	NA	NA	NA	NA	0.0
5/1/18 10:54 PM	album	PatternShift EP	PatternShift	USD	4.0	1.0	4.0	0.0	NA	NA	NA	NA	NA	0.25	paypal	4.0	0.0	0.6	0.6	0.0	3.15	3.15	3.15	digital download	NA	https://patternshift.bandcamp.com/album/patternshift-ep	NA	NA	NA	United States	US	NA
5/3/18 8:20 PM	payout	NA	NA	USD	NA	NA	NA	NA	NA	NA	NA	NA	NA	0.03	transfer	3.15	3.12	NA	NA	NA	-3.15	0.0	NA	NA	NA	NA	NA	NA	NA	NA	NA	0.0
5/11/18 5:00 AM	album	PatternShift EP	PatternShift	USD	4.0	1.0	4.0	0.0	NA	NA	NA	NA	NA	0.25	credit card	4.0	0.0	0.6	0.6	0.0	3.15	3.15	3.15	digital download	NA	https://patternshift.bandcamp.com/album/patternshift-ep	NA	NA	NA	United States	US	NA
5/12/18 8:19 PM	payout	NA	NA	USD	NA	NA	NA	NA	NA	NA	NA	NA	NA	0.03	transfer	3.15	3.12	NA	NA	NA	-3.15	0.0	NA	NA	NA	NA	NA	NA	NA	NA	NA	0.0
5/14/18 2:39 AM	album	PatternShift EP	PatternShift	USD	7.0	1.0	7.0	0.0	NA	NA	NA	NA	NA	0.4	credit card	7.0	0.0	1.05	1.05	0.0	5.55	5.55	5.55	digital download	NA	https://patternshift.bandcamp.com/album/patternshift-ep	NA	NA	NA	United States	US	NA
5/15/18 8:18 PM	payout	NA	NA	USD	NA	NA	NA	NA	NA	NA	NA	NA	NA	0.06	transfer	5.55	5.49	NA	NA	NA	-5.55	0.0	NA	NA	NA	NA	NA	NA	NA	NA	NA	0.0
10/1/18 10:54 AM	album	Four Evocations	PatternShift	USD	3.0	1.0	3.0	0.0	NA	NA	0.57	NA	NA	0.64	credit card	3.57	0.0	0.45	0.0	0.45	0.0	0.0	1.91	digital download	NA	https://patternshift.bandcamp.com/album/four-evocations	NA	800739 617858	NA	Germany	DE	NA
10/1/18 10:54 AM	album	Vaskania Prime	PatternShift	USD	6.0	1.0	6.0	0.0	NA	NA	1.14	NA	NA	NA	NA	7.14	0.0	0.9	1.35	0.0	7.01	7.01	5.1	digital download	NA	https://patternshift.bandcamp.com/album/vaskania-prime	NA	800739 819641	NA	Germany	DE	NA
10/2/18 1:28 PM	bundle	full digital discography (5 releases)	PatternShift	USD	11.0	1.0	11.0	0.0	NA	NA	NA	NA	NA	0.54	credit card	11.0	0.0	1.65	1.65	0.0	8.81	15.82	8.81	digital bundle	NA	https://patternshift.bandcamp.com	NA	NA	NA	United States	US	NA
10/2/18 4:15 PM	bundle	full digital discography (5 releases)	PatternShift	USD	10.5	1.0	10.5	0.0	NA	NA	NA	NA	NA	0.5	paypal	10.5	0.0	1.58	1.58	0.0	8.42	24.24	8.42	digital bundle	NA	https://patternshift.bandcamp.com	NA	NA	NA	United States	US	NA
10/2/18 8:06 PM	payout	NA	NA	USD	NA	NA	NA	NA	NA	NA	NA	NA	NA	0.07	transfer	7.01	6.94	NA	NA	NA	-7.01	17.23	NA	NA	NA	NA	NA	NA	NA	NA	NA	0.0
10/3/18 4:04 PM	album	Vaskania Prime	PatternShift	USD	10.0	1.0	10.0	0.0	NA	NA	NA	NA	NA	0.52	credit card	10.0	0.0	1.5	1.5	0.0	7.98	25.21	7.98	digital download	NA	https://patternshift.bandcamp.com/album/vaskania-prime	NA	800739 819641	NA	United States	US	NA
10/3/18 8:06 PM	payout	NA	NA	USD	NA	NA	NA	NA	NA	NA	NA	NA	NA	0.17	transfer	17.23	17.06	NA	NA	NA	-17.23	7.98	NA	NA	NA	NA	NA	NA	NA	NA	NA	0.0
10/4/18 8:06 PM	payout	NA	NA	USD	NA	NA	NA	NA	NA	NA	NA	NA	NA	0.08	transfer	7.98	7.9	NA	NA	NA	-7.98	0.0	NA	NA	NA	NA	NA	NA	NA	NA	NA	0.0
10/10/18 4:57 PM	album	Vaskania Prime	PatternShift	USD	15.0	1.0	15.0	0.0	NA	NA	NA	NA	NA	0.63	credit card	15.0	0.0	2.25	2.25	0.0	12.12	12.12	12.12	digital download	NA	https://patternshift.bandcamp.com/album/vaskania-prime	NA	800739 819641	NA	United States	US	NA
10/11/18 8:06 PM	payout	NA	NA	USD	NA	NA	NA	NA	NA	NA	NA	NA	NA	0.12	transfer	12.12	12.0	NA	NA	NA	-12.12	0.0	NA	NA	NA	NA	NA	NA	NA	NA	NA	0.0
10/20/18 11:52 AM	bundle	full digital discography (5 releases)	PatternShift	USD	10.5	1.0	10.5	0.0	NA	NA	NA	NA	NA	0.6	paypal	10.5	0.0	1.58	1.58	0.0	8.32	8.32	8.32	digital bundle	NA	https://patternshift.bandcamp.com	NA	NA	NA	Canada	CA	NA
10/21/18 8:06 PM	payout	NA	NA	USD	NA	NA	NA	NA	NA	NA	NA	NA	NA	0.08	transfer	8.32	8.24	NA	NA	NA	-8.32	0.0	NA	NA	NA	NA	NA	NA	NA	NA	NA	0.0
10/26/18 2:25 PM	album	Vaskania Prime	PatternShift	USD	6.0	1.0	6.0	0.0	NA	NA	1.2	NA	NA	0.48	paypal	7.2	0.0	0.9	0.9	0.0	4.62	4.62	4.62	digital download	NA	https://patternshift.bandcamp.com/album/vaskania-prime	NA	800739 819641	NA	United Kingdom	GB	NA
10/27/18 8:06 PM	payout	NA	NA	USD	NA	NA	NA	NA	NA	NA	NA	NA	NA	0.05	transfer	4.62	4.57	NA	NA	NA	-4.62	0.0	NA	NA	NA	NA	NA	NA	NA	NA	NA	0.0
11/4/18 1:13 PM	bundle	full digital discography (5 releases)	PatternShift	USD	10.5	1.0	10.5	0.0	NA	NA	2.1	NA	NA	0.67	paypal	12.6	0.0	1.58	1.58	0.0	8.25	8.25	8.25	digital bundle	NA	https://patternshift.bandcamp.com	NA	NA	NA	United Kingdom	GB	NA
11/5/18 8:06 PM	payout	NA	NA	USD	NA	NA	NA	NA	NA	NA	NA	NA	NA	0.08	transfer	8.25	8.17	NA	NA	NA	-8.25	0.0	NA	NA	NA	NA	NA	NA	NA	NA	NA	0.0
11/6/18 2:01 AM	album	Vaskania Prime	PatternShift	USD	6.0	1.0	6.0	0.0	NA	NA	NA	NA	NA	0.41	credit card	6.0	0.0	0.9	0.9	0.0	4.69	4.69	4.69	digital download	NA	https://patternshift.bandcamp.com/album/vaskania-prime	NA	800739 819641	NA	Switzerland	CH	NA
11/7/18 8:06 PM	payout	NA	NA	USD	NA	NA	NA	NA	NA	NA	NA	NA	NA	0.05	transfer	4.69	4.64	NA	NA	NA	-4.69	0.0	NA	NA	NA	NA	NA	NA	NA	NA	NA	0.0
11/16/18 11:20 PM	track	Solace On Oneiri Station	PatternShift	USD	0.5	1.0	0.5	0.0	NA	NA	NA	NA	NA	0.08	credit card	0.5	0.0	0.08	0.08	0.0	0.34	0.34	0.34	digital download	NA	https://patternshift.bandcamp.com/track/solace-on-oneiri-station	NA	NA	CA-CWV-18-18878	Switzerland	CH	NA
11/17/18 6:33 PM	album	Vaskania Prime	PatternShift	USD	6.0	1.0	6.0	0.0	NA	NA	1.14	NA	NA	0.48	paypal	7.14	0.0	0.9	0.9	0.0	4.62	4.96	4.62	digital download	NA	https://patternshift.bandcamp.com/album/vaskania-prime	NA	800739 819641	NA	Germany	DE	NA
11/18/18 8:06 PM	payout	NA	NA	USD	NA	NA	NA	NA	NA	NA	NA	NA	NA	0.05	transfer	4.96	4.91	NA	NA	NA	-4.96	0.0	NA	NA	NA	NA	NA	NA	NA	NA	NA	0.0
12/7/18 12:51 AM	track	Darklight City	PatternShift	USD	1.0	1.0	1.0	0.0	NA	NA	NA	NA	NA	0.11	paypal	1.0	0.0	0.15	0.15	0.0	0.74	0.74	0.74	digital download	NA	https://patternshift.bandcamp.com/track/darklight-city	NA	NA	CA-CWV-18-36837	Switzerland	CH	NA
12/8/18 8:07 PM	payout	NA	NA	USD	NA	NA	NA	NA	NA	NA	NA	NA	NA	0.01	transfer	0.74	0.73	NA	NA	NA	-0.74	0.0	NA	NA	NA	NA	NA	NA	NA	NA	NA	0.0
1/23/19 12:05 PM	track	Darklight City	PatternShift	USD	1.0	1.0	1.0	0.0	NA	NA	0.2	NA	NA	0.12	paypal	1.2	0.0	0.15	0.15	0.0	0.73	0.73	0.73	digital download	NA	https://patternshift.bandcamp.com/track/darklight-city	NA	NA	CA-CWV-18-36837	United Kingdom	GB	NA
1/24/19 8:04 PM	payout	NA	NA	USD	NA	NA	NA	NA	NA	NA	NA	NA	NA	0.01	transfer	0.73	0.72	NA	NA	NA	-0.73	0.0	NA	NA	NA	NA	NA	NA	NA	NA	NA	0.0
2/8/19 1:23 AM	bundle	full digital discography (7 releases)	PatternShift	USD	15.0	1.0	15.0	0.0	NA	NA	NA	NA	NA	0.74	gift card	15.0	0.0	2.25	2.25	0.0	12.01	12.01	12.01	digital bundle	NA	https://patternshift.bandcamp.com	NA	NA	NA	United States	US	NA
2/9/19 8:04 PM	payout	NA	NA	USD	NA	NA	NA	NA	NA	NA	NA	NA	NA	0.12	transfer	12.01	11.89	NA	NA	NA	-12.01	0.0	NA	NA	NA	NA	NA	NA	NA	NA	NA	0.0
2/19/19 1:12 PM	album	Rites of the Renouncer	PatternShift	USD	4.0	1.0	4.0	0.0	NA	NA	NA	NA	NA	0.25	paypal	4.0	0.0	0.6	0.6	0.0	3.15	3.15	3.15	digital download	NA	https://patternshift.bandcamp.com/album/rites-of-the-renouncer	NA	628810 138654	NA	United States	US	NA
2/20/19 6:58 PM	album	Rites of the Renouncer	PatternShift	USD	10.0	1.0	10.0	0.0	NA	NA	NA	NA	NA	0.52	credit card	10.0	0.0	1.5	1.5	0.0	7.98	11.13	7.98	digital download	NA	https://patternshift.bandcamp.com/album/rites-of-the-renouncer	NA	628810 138654	NA	United States	US	NA
2/20/19 8:04 PM	payout	NA	NA	USD	NA	NA	NA	NA	NA	NA	NA	NA	NA	0.03	transfer	3.15	3.12	NA	NA	NA	-3.15	7.98	NA	NA	NA	NA	NA	NA	NA	NA	NA	0.0
2/21/19 8:04 PM	payout	NA	NA	USD	NA	NA	NA	NA	NA	NA	NA	NA	NA	0.08	transfer	7.98	7.9	NA	NA	NA	-7.98	0.0	NA	NA	NA	NA	NA	NA	NA	NA	NA	0.0
2/22/19 4:09 AM	album	Rites of the Renouncer	PatternShift	USD	4.0	1.0	4.0	0.0	NA	NA	NA	NA	NA	0.25	paypal	4.0	0.0	0.6	0.6	0.0	3.15	3.15	3.15	digital download	NA	https://patternshift.bandcamp.com/album/rites-of-the-renouncer	NA	628810 138654	NA	United States	US	NA
2/22/19 10:25 PM	album	Vaskania Prime	PatternShift	USD	6.0	1.0	6.0	0.0	NA	NA	1.2	NA	NA	0.48	paypal	7.2	0.0	0.9	0.9	0.0	4.62	7.77	4.62	digital download	NA	https://patternshift.bandcamp.com/album/vaskania-prime	NA	800739 819641	NA	United Kingdom	GB	NA
2/23/19 8:04 PM	payout	NA	NA	USD	NA	NA	NA	NA	NA	NA	NA	NA	NA	0.03	transfer	3.15	3.12	NA	NA	NA	-3.15	4.62	NA	NA	NA	NA	NA	NA	NA	NA	NA	0.0
2/24/19 8:04 PM	payout	NA	NA	USD	NA	NA	NA	NA	NA	NA	NA	NA	NA	0.05	transfer	4.62	4.57	NA	NA	NA	-4.62	0.0	NA	NA	NA	NA	NA	NA	NA	NA	NA	0.0
3/1/19 3:43 AM	album	Rites of the Renouncer	PatternShift	USD	4.0	1.0	4.0	0.0	NA	NA	NA	NA	NA	0.25	paypal	4.0	0.0	0.6	0.6	0.0	3.15	3.15	3.15	digital download	NA	https://patternshift.bandcamp.com/album/rites-of-the-renouncer	NA	628810 138654	NA	United States	US	NA
3/2/19 8:04 PM	payout	NA	NA	USD	NA	NA	NA	NA	NA	NA	NA	NA	NA	0.03	transfer	3.15	3.12	NA	NA	NA	-3.15	0.0	NA	NA	NA	NA	NA	NA	NA	NA	NA	0.0
3/18/19 5:47 PM	bundle	full digital discography (8 releases)	PatternShift	USD	15.0	1.0	15.0	0.0	NA	NA	NA	NA	NA	0.59	paypal	15.0	0.0	2.25	2.25	0.0	12.16	12.16	12.16	digital bundle	NA	https://patternshift.bandcamp.com	NA	NA	NA	United States	US	NA
3/19/19 8:04 PM	payout	NA	NA	USD	NA	NA	NA	NA	NA	NA	NA	NA	NA	0.12	transfer	12.16	12.04	NA	NA	NA	-12.16	0.0	NA	NA	NA	NA	NA	NA	NA	NA	NA	0.0
3/20/19 6:17 PM	bundle	full digital discography (8 releases)	PatternShift	USD	15.0	1.0	15.0	0.0	NA	NA	2.71	NA	NA	0.81	paypal	17.71	0.0	2.25	2.25	0.0	11.94	11.94	11.94	digital bundle	NA	https://patternshift.bandcamp.com	NA	NA	NA	Germany	DE	NA
3/21/19 8:04 PM	payout	NA	NA	USD	NA	NA	NA	NA	NA	NA	NA	NA	NA	0.12	transfer	11.94	11.82	NA	NA	NA	-11.94	0.0	NA	NA	NA	NA	NA	NA	NA	NA	NA	0.0
4/13/19 10:28 AM	track	Elitsa's Quest	PatternShift	USD	1.0	1.0	1.0	0.0	NA	NA	0.19	NA	NA	0.12	paypal	1.19	0.0	0.15	0.15	0.0	0.73	0.73	0.73	digital download	NA	https://patternshift.bandcamp.com/track/elitsas-quest	NA	NA	NA	Germany	DE	NA
4/14/19 8:04 PM	payout	NA	NA	USD	NA	NA	NA	NA	NA	NA	NA	NA	NA	0.01	transfer	0.73	0.72	NA	NA	NA	-0.73	0.0	NA	NA	NA	NA	NA	NA	NA	NA	NA	0.0
7/1/19 10:49 PM	track	Elitsa's Quest	PatternShift	USD	1.0	1.0	1.0	0.0	NA	NA	NA	NA	NA	0.49	paypal	1.0	0.0	0.15	0.0	0.15	0.0	0.0	0.36	digital download	NA	https://patternshift.bandcamp.com/track/elitsas-quest	NA	NA	NA	United States	US	NA
7/1/19 10:49 PM	album	Wake of the Wanderer	PatternShift	USD	9.0	1.0	9.0	0.0	NA	NA	NA	NA	NA	NA	NA	9.0	0.0	1.35	1.5	0.0	8.01	8.01	7.65	digital download	NA	https://patternshift.bandcamp.com/album/wake-of-the-wanderer	NA	628810 635399	NA	United States	US	NA
7/3/19 8:04 PM	payout	NA	NA	USD	NA	NA	NA	NA	NA	NA	NA	NA	NA	0.08	transfer	8.01	7.93	NA	NA	NA	-8.01	0.0	NA	NA	NA	NA	NA	NA	NA	NA	NA	0.0
8/13/19 4:00 PM	album	Vaskania Prime	PatternShift	USD	6.0	1.0	6.0	0.0	NA	NA	NA	NA	NA	0.35	paypal	6.0	0.0	0.9	0.9	0.0	4.75	4.75	4.75	digital download	NA	https://patternshift.bandcamp.com/album/vaskania-prime	NA	800739 819641	NA	United States	US	NA
8/14/19 8:04 PM	payout	NA	NA	USD	NA	NA	NA	NA	NA	NA	NA	NA	NA	0.05	transfer	4.75	4.7	NA	NA	NA	-4.75	0.0	NA	NA	NA	NA	NA	NA	NA	NA	NA	0.0
9/12/19 11:47 PM	track	Between Deaths	PatternShift	USD	1.0	1.0	1.0	0.0	NA	NA	0.19	NA	NA	0.12	credit card	1.19	0.0	0.15	0.15	0.0	0.73	0.73	0.73	digital download	NA	https://patternshift.bandcamp.com/track/between-deaths	NA	NA	CA-GOO-19-96417	Germany	DE	NA
9/14/19 8:02 PM	payout	NA	NA	USD	NA	NA	NA	NA	NA	NA	NA	NA	NA	0.01	transfer	0.73	0.72	NA	NA	NA	-0.73	0.0	NA	NA	NA	NA	NA	NA	NA	NA	NA	0.0
9/20/19 4:17 AM	track	Low Gravity Judo	PatternShift	USD	1.0	1.0	1.0	0.0	NA	NA	NA	NA	NA	0.1	paypal	1.0	0.0	0.15	0.15	0.0	0.75	0.75	0.75	digital download	NA	https://patternshift.bandcamp.com/track/low-gravity-judo	NA	NA	CA-HQJ-18-85077	United States	US	NA
9/20/19 4:22 AM	track	Tidal Resonance	PatternShift	USD	1.0	1.0	1.0	0.0	NA	NA	NA	NA	NA	0.1	paypal	1.0	0.0	0.15	0.15	0.0	0.75	1.5	0.75	digital download	NA	https://patternshift.bandcamp.com/track/tidal-resonance	NA	NA	CA-HQJ-18-85075	United States	US	NA
9/21/19 8:03 PM	payout	NA	NA	USD	NA	NA	NA	NA	NA	NA	NA	NA	NA	0.02	transfer	1.5	1.48	NA	NA	NA	-1.5	0.0	NA	NA	NA	NA	NA	NA	NA	NA	NA	0.0
9/26/19 12:21 PM	album	Wake of the Wanderer	PatternShift	USD	10.0	1.0	10.0	0.0	NA	NA	NA	NA	NA	0.52	credit card	10.0	0.0	1.5	1.5	0.0	7.98	7.98	7.98	digital download	NA	https://patternshift.bandcamp.com/album/wake-of-the-wanderer	NA	628810 635399	NA	United States	US	NA
9/27/19 8:02 PM	payout	NA	NA	USD	NA	NA	NA	NA	NA	NA	NA	NA	NA	0.08	transfer	7.98	7.9	NA	NA	NA	-7.98	0.0	NA	NA	NA	NA	NA	NA	NA	NA	NA	0.0
11/4/19 4:49 AM	album	Vaskania Prime	PatternShift	USD	6.0	1.0	6.0	0.0	NA	NA	NA	NA	NA	0.35	credit card	6.0	0.0	0.9	0.9	0.0	4.75	4.75	4.75	digital download	NA	https://patternshift.bandcamp.com/album/vaskania-prime	NA	800739 819641	NA	United States	US	NA
11/5/19 8:03 PM	payout	NA	NA	USD	NA	NA	NA	NA	NA	NA	NA	NA	NA	0.05	transfer	4.75	4.7	NA	NA	NA	-4.75	0.0	NA	NA	NA	NA	NA	NA	NA	NA	NA	0.0
11/24/19 6:00 PM	track	Reality Anchor	PatternShift	USD	1.0	1.0	1.0	0.0	NA	NA	NA	NA	NA	0.11	credit card	1.0	0.0	0.15	0.0	0.15	0.0	0.0	0.74	digital download	NA	https://patternshift.bandcamp.com/track/reality-anchor	NA	NA	CA-HQJ-18-85079	United States	US	NA
11/24/19 6:00 PM	track	Lake Reflections	PatternShift	USD	1.0	1.0	1.0	0.0	NA	NA	NA	NA	NA	NA	NA	1.0	0.0	0.15	0.0	0.3	0.0	0.0	0.85	digital download	NA	https://patternshift.bandcamp.com/track/lake-reflections	NA	NA	CA-GOO-19-96415	United States	US	NA
11/24/19 6:00 PM	track	Remember the Void	PatternShift	USD	1.0	1.0	1.0	0.0	NA	NA	NA	NA	NA	NA	NA	1.0	0.0	0.15	0.45	0.0	2.44	2.44	0.85	digital download	NA	https://patternshift.bandcamp.com/track/remember-the-void	NA	NA	CA-GOO-19-96414	United States	US	NA
11/25/19 8:03 PM	payout	NA	NA	USD	NA	NA	NA	NA	NA	NA	NA	NA	NA	0.02	transfer	2.44	2.42	NA	NA	NA	-2.44	0.0	NA	NA	NA	NA	NA	NA	NA	NA	NA	0.0
12/8/19 4:12 AM	album	Rituals from the Distant Past, Memories from the Far Future	PatternShift	USD	4.0	1.0	4.0	0.0	NA	NA	NA	NA	NA	0.25	paypal	4.0	0.0	0.6	0.6	0.0	3.15	3.15	3.15	digital download	NA	https://patternshift.bandcamp.com/album/rituals-from-the-distant-past-memories-from-the-far-future	NA	628810 896967	NA	United States	US	NA
12/8/19 6:26 PM	album	Rituals from the Distant Past, Memories from the Far Future	PatternShift	USD	1.0	1.0	1.0	0.0	NA	NA	NA	NA	NA	0.11	credit card	1.0	0.0	0.15	0.15	0.0	0.74	3.89	0.74	digital download	NA	https://patternshift.bandcamp.com/album/rituals-from-the-distant-past-memories-from-the-far-future	NA	628810 896967	NA	Germany	DE	NA
12/9/19 8:04 PM	payout	NA	NA	USD	NA	NA	NA	NA	NA	NA	NA	NA	NA	0.04	transfer	3.89	3.85	NA	NA	NA	-3.89	0.0	NA	NA	NA	NA	NA	NA	NA	NA	NA	0.0
12/10/19 12:12 PM	album	Rituals from the Distant Past, Memories from the Far Future	PatternShift	USD	1.0	1.0	1.0	0.0	NA	NA	NA	NA	NA	0.11	paypal	1.0	0.0	0.15	0.15	0.0	0.74	0.74	0.74	digital download	NA	https://patternshift.bandcamp.com/album/rituals-from-the-distant-past-memories-from-the-far-future	NA	628810 896967	NA	Italy	IT	NA
12/11/19 8:03 PM	payout	NA	NA	USD	NA	NA	NA	NA	NA	NA	NA	NA	NA	0.01	transfer	0.74	0.73	NA	NA	NA	-0.74	0.0	NA	NA	NA	NA	NA	NA	NA	NA	NA	0.0
12/12/19 8:06 PM	album	Rituals from the Distant Past, Memories from the Far Future	PatternShift	USD	1.0	1.0	1.0	0.0	NA	NA	NA	NA	NA	0.11	credit card	1.0	0.0	0.15	0.15	0.0	0.74	0.74	0.74	digital download	NA	https://patternshift.bandcamp.com/album/rituals-from-the-distant-past-memories-from-the-far-future	NA	628810 896967	NA	Brazil	BR	NA
12/14/19 8:03 PM	payout	NA	NA	USD	NA	NA	NA	NA	NA	NA	NA	NA	NA	0.01	transfer	0.74	0.73	NA	NA	NA	-0.74	0.0	NA	NA	NA	NA	NA	NA	NA	NA	NA	0.0
12/16/19 5:28 PM	album	Rituals from the Distant Past, Memories from the Far Future	PatternShift	USD	1.0	1.0	1.0	0.0	NA	NA	NA	NA	NA	0.11	credit card	1.0	0.0	0.15	0.15	0.0	0.74	0.74	0.74	digital download	NA	https://patternshift.bandcamp.com/album/rituals-from-the-distant-past-memories-from-the-far-future	NA	628810 896967	NA	Ireland	IE	NA
12/17/19 8:03 PM	payout	NA	NA	USD	NA	NA	NA	NA	NA	NA	NA	NA	NA	0.01	transfer	0.74	0.73	NA	NA	NA	-0.74	0.0	NA	NA	NA	NA	NA	NA	NA	NA	NA	0.0
12/22/19 4:25 PM	album	Rituals from the Distant Past, Memories from the Far Future	PatternShift	USD	5.0	1.0	5.0	0.0	NA	NA	NA	NA	NA	0.3	paypal	5.0	0.0	0.75	0.75	0.0	3.95	3.95	3.95	digital download	NA	https://patternshift.bandcamp.com/album/rituals-from-the-distant-past-memories-from-the-far-future	NA	628810 896967	NA	United States	US	NA
12/23/19 8:04 PM	payout	NA	NA	USD	NA	NA	NA	NA	NA	NA	NA	NA	NA	0.04	transfer	3.95	3.91	NA	NA	NA	-3.95	0.0	NA	NA	NA	NA	NA	NA	NA	NA	NA	0.0
1/3/20 7:49 PM	album	Wake of the Wanderer	PatternShift	USD	8.0	1.0	8.0	0.0	NA	NA	NA	NA	NA	0.52	credit card	8.0	0.0	1.2	0.0	1.2	0.0	0.0	6.28	digital download	NA	https://patternshift.bandcamp.com/album/wake-of-the-wanderer	NA	628810 635399	NA	United States	US	NA
1/3/20 7:49 PM	album	Rituals from the Distant Past, Memories from the Far Future	PatternShift	USD	2.0	1.0	2.0	0.0	NA	NA	NA	NA	NA	NA	NA	2.0	0.0	0.3	1.5	0.0	7.98	7.98	1.7	digital download	NA	https://patternshift.bandcamp.com/album/rituals-from-the-distant-past-memories-from-the-far-future	NA	628810 896967	NA	United States	US	NA
1/4/20 8:03 PM	payout	NA	NA	USD	NA	NA	NA	NA	NA	NA	NA	NA	NA	0.08	transfer	7.98	7.9	NA	NA	NA	-7.98	0.0	NA	NA	NA	NA	NA	NA	NA	NA	NA	0.0
1/5/20 10:10 PM	album	Rituals from the Distant Past, Memories from the Far Future	PatternShift	USD	1.12	1.0	1.12	0.0	NA	NA	NA	NA	NA	0.12	paypal	1.12	0.0	0.17	0.17	0.0	0.83	0.83	0.83	digital download	NA	https://patternshift.bandcamp.com/album/rituals-from-the-distant-past-memories-from-the-far-future	NA	628810 896967	NA	United Kingdom	GB	NA
1/7/20 8:02 PM	payout	NA	NA	USD	NA	NA	NA	NA	NA	NA	NA	NA	NA	0.01	transfer	0.83	0.82	NA	NA	NA	-0.83	0.0	NA	NA	NA	NA	NA	NA	NA	NA	NA	0.0
1/23/20 11:42 PM	bundle	full digital discography (11 releases)	PatternShift	USD	16.8	1.0	16.8	0.0	NA	NA	3.36	NA	NA	0.95	credit card	20.16	0.0	2.52	2.52	0.0	13.33	13.33	13.33	digital bundle	NA	https://patternshift.bandcamp.com	NA	NA	NA	United Kingdom	GB	NA
1/25/20 8:03 PM	payout	NA	NA	USD	NA	NA	NA	NA	NA	NA	NA	NA	NA	0.13	transfer	13.33	13.2	NA	NA	NA	-13.33	0.0	NA	NA	NA	NA	NA	NA	NA	NA	NA	0.0
2/27/20 2:10 AM	album	Vaskania Prime	PatternShift	USD	7.0	1.0	7.0	0.0	NA	NA	NA	NA	NA	0.47	credit card	7.0	0.0	1.05	1.05	0.0	5.48	5.48	5.48	digital download	NA	https://patternshift.bandcamp.com/album/vaskania-prime	NA	800739 819641	NA	Thailand	TH	NA
2/28/20 8:03 PM	payout	NA	NA	USD	NA	NA	NA	NA	NA	NA	NA	NA	NA	0.05	transfer	5.48	5.43	NA	NA	NA	-5.48	0.0	NA	NA	NA	NA	NA	NA	NA	NA	NA	0.0
3/4/20 3:09 AM	album	Testament of the Earth Sage	PatternShift	USD	3.0	1.0	3.0	0.0	NA	NA	NA	NA	NA	0.2	paypal	3.0	0.0	0.45	0.45	0.0	2.35	2.35	2.35	digital download	NA	https://patternshift.bandcamp.com/album/testament-of-the-earth-sage	NA	672985 108011	NA	United States	US	NA
3/4/20 3:21 AM	album	Testament of the Earth Sage	PatternShift	USD	4.0	1.0	4.0	0.0	NA	NA	NA	NA	NA	0.29	paypal	4.0	0.0	0.6	0.6	0.0	3.11	5.46	3.11	digital download	NA	https://patternshift.bandcamp.com/album/testament-of-the-earth-sage	NA	672985 108011	NA	Canada	CA	NA
3/5/20 8:04 PM	payout	NA	NA	USD	NA	NA	NA	NA	NA	NA	NA	NA	NA	0.05	transfer	5.46	5.41	NA	NA	NA	-5.46	0.0	NA	NA	NA	NA	NA	NA	NA	NA	NA	0.0
3/21/20 12:02 AM	bundle	full digital discography (12 releases)	PatternShift	USD	17.0	1.0	17.0	0.0	NA	NA	NA	NA	NA	0.67	credit card	17.0	0.0	0.0	0.0	0.0	16.33	16.33	16.33	digital bundle	NA	https://patternshift.bandcamp.com	NA	NA	NA	United States	US	NA
3/22/20 2:16 AM	album	Rituals from the Distant Past, Memories from the Far Future	PatternShift	USD	1.0	1.0	1.0	0.0	NA	NA	NA	NA	NA	0.1	paypal	1.0	0.0	0.15	0.15	0.0	0.75	17.08	0.75	digital download	NA	https://patternshift.bandcamp.com/album/rituals-from-the-distant-past-memories-from-the-far-future	NA	628810 896967	NA	United States	US	NA
3/22/20 8:09 PM	payout	NA	NA	USD	NA	NA	NA	NA	NA	NA	NA	NA	NA	0.16	transfer	16.33	16.17	NA	NA	NA	-16.33	0.75	NA	NA	NA	NA	NA	NA	NA	NA	NA	0.0
3/23/20 8:15 PM	payout	NA	NA	USD	NA	NA	NA	NA	NA	NA	NA	NA	NA	0.01	transfer	0.75	0.74	NA	NA	NA	-0.75	0.0	NA	NA	NA	NA	NA	NA	NA	NA	NA	0.0
3/25/20 12:14 AM	bundle	full digital discography (12 releases)	PatternShift	USD	20.0	1.0	20.0	0.0	NA	NA	NA	NA	NA	0.74	credit card	20.0	0.0	3.0	3.0	0.0	16.26	16.26	16.26	digital bundle	NA	https://patternshift.bandcamp.com	NA	NA	NA	United States	US	NA
3/26/20 8:04 PM	payout	NA	NA	USD	NA	NA	NA	NA	NA	NA	NA	NA	NA	0.16	transfer	16.26	16.1	NA	NA	NA	-16.26	0.0	NA	NA	NA	NA	NA	NA	NA	NA	NA	0.0
3/31/20 8:07 PM	album	Testament of the Earth Sage	PatternShift	USD	1.0	1.0	1.0	0.0	NA	NA	NA	NA	NA	0.11	paypal	1.0	0.0	0.15	0.15	0.0	0.74	0.74	0.74	digital download	NA	https://patternshift.bandcamp.com/album/testament-of-the-earth-sage	NA	672985 108011	NA	Italy	IT	NA
4/2/20 8:04 PM	payout	NA	NA	USD	NA	NA	NA	NA	NA	NA	NA	NA	NA	0.01	transfer	0.74	0.73	NA	NA	NA	-0.74	0.0	NA	NA	NA	NA	NA	NA	NA	NA	NA	0.0
4/2/20 10:19 PM	bundle	full digital discography (12 releases)	PatternShift	USD	20.0	1.0	20.0	0.0	NA	NA	4.03	NA	NA	1.07	credit card	24.03	0.0	3.0	3.0	0.0	15.93	15.93	15.93	digital bundle	NA	https://patternshift.bandcamp.com	NA	NA	NA	Finland	FI	NA
4/4/20 8:04 PM	payout	NA	NA	USD	NA	NA	NA	NA	NA	NA	NA	NA	NA	0.16	transfer	15.93	15.77	NA	NA	NA	-15.93	0.0	NA	NA	NA	NA	NA	NA	NA	NA	NA	0.0
4/9/20 5:26 PM	album	Testament of the Earth Sage	PatternShift	USD	1.0	1.0	1.0	0.0	NA	NA	NA	NA	NA	0.1	paypal	1.0	0.0	0.15	0.15	0.0	0.75	0.75	0.75	digital download	NA	https://patternshift.bandcamp.com/album/testament-of-the-earth-sage	NA	672985 108011	NA	United States	US	NA
4/10/20 8:04 PM	payout	NA	NA	USD	NA	NA	NA	NA	NA	NA	NA	NA	NA	0.01	transfer	0.75	0.74	NA	NA	NA	-0.75	0.0	NA	NA	NA	NA	NA	NA	NA	NA	NA	0.0
4/14/20 12:26 PM	track	Change of Basis	PatternShift	USD	1.0	1.0	1.0	0.0	NA	NA	0.2	NA	NA	0.12	paypal	1.2	0.0	0.15	0.15	0.0	0.73	0.73	0.73	digital download	NA	https://patternshift.bandcamp.com/track/change-of-basis	NA	NA	CA-GOO-19-96418	France	FR	NA
4/15/20 8:04 PM	payout	NA	NA	USD	NA	NA	NA	NA	NA	NA	NA	NA	NA	0.01	transfer	0.73	0.72	NA	NA	NA	-0.73	0.0	NA	NA	NA	NA	NA	NA	NA	NA	NA	0.0
5/1/20 10:26 AM	album	Testament of the Earth Sage	PatternShift	USD	1.0	1.0	1.0	0.0	NA	NA	NA	NA	NA	0.11	paypal	1.0	0.0	0.0	0.0	0.0	0.89	0.89	0.89	digital download	NA	https://patternshift.bandcamp.com/album/testament-of-the-earth-sage	NA	672985 108011	NA	Italy	IT	NA
5/2/20 3:28 AM	album	Testament of the Earth Sage	PatternShift	USD	1.0	1.0	1.0	0.0	NA	NA	NA	NA	NA	0.1	paypal	1.0	0.0	0.0	0.0	0.0	0.9	1.79	0.9	digital download	NA	https://patternshift.bandcamp.com/album/testament-of-the-earth-sage	NA	672985 108011	NA	United States	US	NA
5/2/20 8:14 PM	payout	NA	NA	USD	NA	NA	NA	NA	NA	NA	NA	NA	NA	0.01	transfer	0.89	0.88	NA	NA	NA	-0.89	0.9	NA	NA	NA	NA	NA	NA	NA	NA	NA	0.0
5/3/20 8:17 PM	payout	NA	NA	USD	NA	NA	NA	NA	NA	NA	NA	NA	NA	0.01	transfer	0.9	0.89	NA	NA	NA	-0.9	0.0	NA	NA	NA	NA	NA	NA	NA	NA	NA	0.0
5/7/20 8:58 PM	bundle	full digital discography (12 releases)	PatternShift	USD	15.0	1.0	15.0	0.0	NA	NA	2.4	NA	NA	0.8	paypal	17.4	0.0	2.25	2.25	0.0	11.95	11.95	11.95	digital bundle	NA	https://patternshift.bandcamp.com	NA	NA	NA	Canada	CA	NA
5/9/20 8:04 PM	payout	NA	NA	USD	NA	NA	NA	NA	NA	NA	NA	NA	NA	0.12	transfer	11.95	11.83	NA	NA	NA	-11.95	0.0	NA	NA	NA	NA	NA	NA	NA	NA	NA	0.0
5/11/20 1:17 PM	album	Vaskania Prime	PatternShift	USD	10.0	1.0	10.0	0.0	NA	NA	NA	NA	NA	0.52	credit card	10.0	0.0	1.5	1.5	0.0	7.98	7.98	7.98	digital download	NA	https://patternshift.bandcamp.com/album/vaskania-prime	NA	800739 819641	NA	United States	US	NA
5/12/20 8:03 PM	payout	NA	NA	USD	NA	NA	NA	NA	NA	NA	NA	NA	NA	0.08	transfer	7.98	7.9	NA	NA	NA	-7.98	0.0	NA	NA	NA	NA	NA	NA	NA	NA	NA	0.0
5/24/20 10:06 AM	bundle	full digital discography (12 releases)	PatternShift	USD	12.0	1.0	12.0	0.0	NA	NA	2.4	NA	NA	0.72	paypal	14.4	0.0	1.8	1.8	0.0	9.48	9.48	9.48	digital bundle	NA	https://patternshift.bandcamp.com	NA	NA	NA	United Kingdom	GB	NA
5/25/20 8:03 PM	payout	NA	NA	USD	NA	NA	NA	NA	NA	NA	NA	NA	NA	0.09	transfer	9.48	9.39	NA	NA	NA	-9.48	0.0	NA	NA	NA	NA	NA	NA	NA	NA	NA	0.0
6/5/20 11:58 PM	album	New Worlds Born in Fire	PatternShift	USD	1.0	1.0	1.0	0.0	NA	NA	NA	NA	NA	0.1	credit card	1.0	0.0	0.0	0.0	0.0	0.9	0.9	0.9	digital download	NA	https://patternshift.bandcamp.com/album/new-worlds-born-in-fire	NA	NA	NA	United States	US	NA
6/6/20 12:21 AM	album	New Worlds Born in Fire	PatternShift	USD	6.33	1.0	6.33	0.0	NA	NA	NA	NA	NA	0.43	paypal	6.33	0.0	0.0	0.0	0.0	5.9	6.8	5.9	digital download	NA	https://patternshift.bandcamp.com/album/new-worlds-born-in-fire	NA	NA	NA	United Kingdom	GB	NA
6/6/20 3:34 PM	bundle	full digital discography (13 releases)	PatternShift	USD	12.0	1.0	12.0	0.0	NA	NA	NA	NA	NA	0.53	paypal	12.0	0.0	1.8	1.8	0.0	9.67	16.47	9.67	digital bundle	NA	https://patternshift.bandcamp.com	NA	NA	NA	United States	US	NA
6/7/20 1:37 AM	bundle	full digital discography (13 releases)	PatternShift	USD	15.0	1.0	15.0	0.0	NA	NA	NA	NA	NA	0.59	paypal	15.0	0.0	2.25	2.25	0.0	12.16	28.63	12.16	digital bundle	NA	https://patternshift.bandcamp.com	NA	NA	NA	United States	US	NA
6/7/20 8:09 PM	payout	NA	NA	USD	NA	NA	NA	NA	NA	NA	NA	NA	NA	0.1	transfer	9.67	9.57	NA	NA	NA	-9.67	18.96	NA	NA	NA	NA	NA	NA	NA	NA	NA	0.0
6/7/20 8:09 PM	payout	NA	NA	USD	NA	NA	NA	NA	NA	NA	NA	NA	NA	0.07	transfer	6.8	6.73	NA	NA	NA	-6.8	12.16	NA	NA	NA	NA	NA	NA	NA	NA	NA	0.0
6/8/20 8:03 PM	payout	NA	NA	USD	NA	NA	NA	NA	NA	NA	NA	NA	NA	0.12	transfer	12.16	12.04	NA	NA	NA	-12.16	0.0	NA	NA	NA	NA	NA	NA	NA	NA	NA	0.0
6/17/20 6:03 PM	album	New Worlds Born in Fire	PatternShift	USD	30.0	1.0	30.0	0.0	NA	NA	NA	NA	NA	0.87	paypal	30.0	0.0	4.5	4.5	0.0	24.63	24.63	24.63	digital download	NA	https://patternshift.bandcamp.com/album/new-worlds-born-in-fire	NA	NA	NA	United States	US	NA
6/18/20 3:16 PM	bundle	full digital discography (13 releases)	PatternShift	USD	12.0	1.0	12.0	0.0	NA	NA	NA	NA	NA	0.65	paypal	12.0	0.0	1.8	1.8	0.0	9.55	34.18	9.55	digital bundle	NA	https://patternshift.bandcamp.com	NA	NA	NA	Japan	JP	NA
6/18/20 8:04 PM	payout	NA	NA	USD	NA	NA	NA	NA	NA	NA	NA	NA	NA	0.25	transfer	24.63	24.38	NA	NA	NA	-24.63	9.55	NA	NA	NA	NA	NA	NA	NA	NA	NA	0.0
6/19/20 3:06 PM	album	Interoception	PatternShift	USD	2.0	1.0	2.0	0.0	NA	NA	0.4	NA	NA	0.19	paypal	2.4	0.0	0.3	0.3	0.0	1.51	11.06	1.51	digital download	NA	https://patternshift.bandcamp.com/album/interoception	NA	NA	NA	United Kingdom	GB	NA
6/19/20 3:36 PM	album	PatternShift EP	PatternShift	USD	3.0	1.0	3.0	0.0	NA	NA	NA	NA	NA	0.23	paypal	3.0	0.0	0.45	0.45	0.0	2.32	13.38	2.32	digital download	NA	https://patternshift.bandcamp.com/album/patternshift-ep	NA	NA	NA	Canada	CA	NA
6/19/20 8:04 PM	payout	NA	NA	USD	NA	NA	NA	NA	NA	NA	NA	NA	NA	0.1	transfer	9.55	9.45	NA	NA	NA	-9.55	3.83	NA	NA	NA	NA	NA	NA	NA	NA	NA	0.0
6/19/20 10:44 PM	album	New Worlds Born in Fire	PatternShift	USD	2.0	1.0	2.0	0.0	NA	NA	NA	NA	NA	0.25	gift card	2.0	0.0	0.3	0.0	0.3	0.0	3.83	1.45	digital download	NA	https://patternshift.bandcamp.com/album/new-worlds-born-in-fire	NA	NA	NA	Canada	CA	NA
6/19/20 10:44 PM	album	Interoception	PatternShift	USD	2.0	1.0	2.0	0.0	NA	NA	NA	NA	NA	NA	NA	2.0	0.0	0.3	0.6	0.0	3.15	6.98	1.7	digital download	NA	https://patternshift.bandcamp.com/album/interoception	NA	NA	NA	Canada	CA	NA
6/19/20 10:53 PM	bundle	full digital discography (14 releases)	PatternShift	USD	30.0	1.0	30.0	0.0	NA	NA	NA	NA	NA	0.96	credit card	30.0	0.0	4.5	4.5	0.0	24.54	31.52	24.54	digital bundle	NA	https://patternshift.bandcamp.com	NA	NA	NA	United States	US	NA
6/20/20 12:27 AM	album	Interoception	PatternShift	USD	2.0	1.0	2.0	0.0	NA	NA	NA	NA	NA	0.68	paypal	2.0	0.0	0.3	0.0	0.3	0.0	31.52	1.02	digital download	NA	https://patternshift.bandcamp.com/album/interoception	NA	NA	NA	United States	US	NA
6/20/20 12:27 AM	album	Wake of the Wanderer	PatternShift	USD	8.0	1.0	8.0	0.0	NA	NA	NA	NA	NA	NA	NA	8.0	0.0	1.2	0.0	1.5	0.0	31.52	6.8	digital download	NA	https://patternshift.bandcamp.com/album/wake-of-the-wanderer	NA	628810 635399	NA	United States	US	NA
6/20/20 12:27 AM	album	New Worlds Born in Fire	PatternShift	USD	2.5	1.0	2.5	0.0	NA	NA	NA	NA	NA	NA	NA	2.5	0.0	0.38	0.0	1.88	0.0	31.52	2.12	digital download	NA	https://patternshift.bandcamp.com/album/new-worlds-born-in-fire	NA	NA	NA	United States	US	NA
6/20/20 12:27 AM	album	Testament of the Earth Sage	PatternShift	USD	2.5	1.0	2.5	0.0	NA	NA	NA	NA	NA	NA	NA	2.5	0.0	0.38	0.0	2.26	0.0	31.52	2.12	digital download	NA	https://patternshift.bandcamp.com/album/testament-of-the-earth-sage	NA	672985 108011	NA	United States	US	NA
6/20/20 12:27 AM	album	Rituals from the Distant Past, Memories from the Far Future	PatternShift	USD	2.5	1.0	2.5	0.0	NA	NA	NA	NA	NA	NA	NA	2.5	0.0	0.38	0.0	2.64	0.0	31.52	2.12	digital download	NA	https://patternshift.bandcamp.com/album/rituals-from-the-distant-past-memories-from-the-far-future	NA	628810 896967	NA	United States	US	NA
6/20/20 12:27 AM	album	Four Evocations	PatternShift	USD	2.5	1.0	2.5	0.0	NA	NA	NA	NA	NA	NA	NA	2.5	0.0	0.38	3.02	0.0	16.3	47.82	2.12	digital download	NA	https://patternshift.bandcamp.com/album/four-evocations	NA	800739 617858	NA	United States	US	NA
6/20/20 8:05 PM	payout	NA	NA	USD	NA	NA	NA	NA	NA	NA	NA	NA	NA	0.04	transfer	3.83	3.79	NA	NA	NA	-3.83	43.99	NA	NA	NA	NA	NA	NA	NA	NA	NA	0.0
6/21/20 8:05 PM	payout	NA	NA	USD	NA	NA	NA	NA	NA	NA	NA	NA	NA	0.44	transfer	43.99	43.55	NA	NA	NA	-43.99	0.0	NA	NA	NA	NA	NA	NA	NA	NA	NA	0.0
6/21/20 10:02 PM	album	Interoception	PatternShift	USD	2.0	1.0	2.0	0.0	NA	NA	0.4	NA	NA	0.19	paypal	2.4	0.0	0.3	0.3	0.0	1.51	1.51	1.51	digital download	NA	https://patternshift.bandcamp.com/album/interoception	NA	NA	NA	United Kingdom	GB	NA
6/23/20 8:03 PM	payout	NA	NA	USD	NA	NA	NA	NA	NA	NA	NA	NA	NA	0.02	transfer	1.51	1.49	NA	NA	NA	-1.51	0.0	NA	NA	NA	NA	NA	NA	NA	NA	NA	0.0
6/26/20 2:40 PM	track	Interoception	PatternShift	USD	1.0	1.0	1.0	0.0	NA	NA	0.19	NA	NA	0.12	credit card	1.19	0.0	0.15	0.15	0.0	0.73	0.73	0.73	digital download	NA	https://patternshift.bandcamp.com/track/interoception	NA	NA	NA	Germany	DE	NA
6/27/20 8:04 PM	payout	NA	NA	USD	NA	NA	NA	NA	NA	NA	NA	NA	NA	0.01	transfer	0.73	0.72	NA	NA	NA	-0.73	0.0	NA	NA	NA	NA	NA	NA	NA	NA	NA	0.0
7/1/20 9:19 PM	bundle	full digital discography (14 releases)	PatternShift	USD	13.2	1.0	13.2	0.0	NA	NA	NA	NA	NA	0.68	paypal	13.2	0.0	1.98	1.98	0.0	10.54	10.54	10.54	digital bundle	NA	https://patternshift.bandcamp.com	NA	NA	NA	Mexico	MX	NA
7/3/20 8:04 PM	payout	NA	NA	USD	NA	NA	NA	NA	NA	NA	NA	NA	NA	0.11	transfer	10.54	10.43	NA	NA	NA	-10.54	0.0	NA	NA	NA	NA	NA	NA	NA	NA	NA	0.0
7/27/20 3:58 PM	bundle	full digital discography (14 releases)	PatternShift	USD	15.0	1.0	15.0	0.0	NA	NA	2.64	NA	NA	0.86	credit card	17.64	0.0	2.25	2.25	0.0	11.89	11.89	11.89	digital bundle	NA	https://patternshift.bandcamp.com	NA	NA	NA	United Kingdom	GB	NA
7/28/20 8:14 PM	payout	NA	NA	USD	NA	NA	NA	NA	NA	NA	NA	NA	NA	0.12	transfer	11.89	11.77	NA	NA	NA	-11.89	0.0	NA	NA	NA	NA	NA	NA	NA	NA	NA	0.0
8/7/20 2:05 PM	bundle	full digital discography (15 releases)	PatternShift	USD	30.0	1.0	30.0	0.0	NA	NA	NA	NA	NA	0.87	paypal	30.0	0.0	0.0	0.0	0.0	29.13	29.13	29.13	digital bundle	NA	https://patternshift.bandcamp.com	NA	NA	NA	United States	US	NA
8/7/20 3:41 PM	album	Fragments of the Fleet	PatternShift	USD	7.0	1.0	7.0	0.0	NA	NA	NA	NA	NA	0.4	paypal	7.0	0.0	0.0	0.0	0.0	6.6	35.73	6.6	digital download	NA	https://patternshift.bandcamp.com/album/fragments-of-the-fleet	NA	672985 458529	NA	United States	US	NA
8/7/20 3:51 PM	album	Fragments of the Fleet	PatternShift	USD	7.0	1.0	7.0	0.0	NA	NA	NA	NA	NA	0.4	paypal	7.0	0.0	0.0	0.0	0.0	6.6	42.33	6.6	digital download	NA	https://patternshift.bandcamp.com/album/fragments-of-the-fleet	NA	672985 458529	NA	United States	US	NA
8/7/20 6:02 PM	album	Fragments of the Fleet	PatternShift	USD	20.0	1.0	20.0	0.0	NA	NA	NA	NA	NA	0.68	paypal	20.0	0.0	0.0	0.0	0.0	19.32	61.65	19.32	digital download	NA	https://patternshift.bandcamp.com/album/fragments-of-the-fleet	NA	672985 458529	NA	United States	US	NA
8/7/20 8:06 PM	album	Fragments of the Fleet	PatternShift	USD	7.0	1.0	7.0	0.0	NA	NA	NA	NA	NA	0.4	paypal	7.0	0.0	0.0	0.0	0.0	6.6	68.25	6.6	digital download	NA	https://patternshift.bandcamp.com/album/fragments-of-the-fleet	NA	672985 458529	NA	United States	US	NA
8/7/20 10:56 PM	album	Fragments of the Fleet	PatternShift	USD	7.0	1.0	7.0	0.0	NA	NA	NA	NA	NA	0.4	paypal	7.0	0.0	0.0	0.0	0.0	6.6	74.85	6.6	digital download	NA	https://patternshift.bandcamp.com/album/fragments-of-the-fleet	NA	672985 458529	NA	United States	US	NA
8/8/20 1:08 AM	album	Fragments of the Fleet	PatternShift	USD	7.0	1.0	7.0	0.0	NA	NA	1.4	NA	NA	0.54	paypal	8.4	0.0	0.0	0.0	0.0	6.46	81.31	6.46	digital download	NA	https://patternshift.bandcamp.com/album/fragments-of-the-fleet	NA	672985 458529	NA	United Kingdom	GB	NA
8/8/20 8:21 PM	payout	NA	NA	USD	NA	NA	NA	NA	NA	NA	NA	NA	NA	0.2	transfer	19.8	19.6	NA	NA	NA	-19.8	61.51	NA	NA	NA	NA	NA	NA	NA	NA	NA	0.0
8/8/20 8:21 PM	payout	NA	NA	USD	NA	NA	NA	NA	NA	NA	NA	NA	NA	0.48	transfer	48.45	47.97	NA	NA	NA	-48.45	13.06	NA	NA	NA	NA	NA	NA	NA	NA	NA	0.0
8/9/20 2:15 AM	bundle	full digital discography (15 releases)	PatternShift	USD	20.0	1.0	20.0	0.0	NA	NA	NA	NA	NA	0.74	credit card	20.0	0.0	3.0	3.0	0.0	16.26	29.32	16.26	digital bundle	NA	https://patternshift.bandcamp.com	NA	NA	NA	United States	US	NA
8/9/20 8:19 PM	payout	NA	NA	USD	NA	NA	NA	NA	NA	NA	NA	NA	NA	0.07	transfer	6.6	6.53	NA	NA	NA	-6.6	22.72	NA	NA	NA	NA	NA	NA	NA	NA	NA	0.0
8/9/20 8:19 PM	payout	NA	NA	USD	NA	NA	NA	NA	NA	NA	NA	NA	NA	0.06	transfer	6.46	6.4	NA	NA	NA	-6.46	16.26	NA	NA	NA	NA	NA	NA	NA	NA	NA	0.0
8/10/20 8:15 PM	payout	NA	NA	USD	NA	NA	NA	NA	NA	NA	NA	NA	NA	0.16	transfer	16.26	16.1	NA	NA	NA	-16.26	0.0	NA	NA	NA	NA	NA	NA	NA	NA	NA	0.0
8/11/20 6:58 PM	album	Interoception	PatternShift	USD	2.0	1.0	2.0	0.0	NA	NA	NA	NA	NA	0.47	paypal	2.0	0.0	0.3	0.0	0.3	0.0	0.0	1.23	digital download	NA	https://patternshift.bandcamp.com/album/interoception	NA	NA	NA	United States	US	NA
8/11/20 6:58 PM	album	Fragments of the Fleet	PatternShift	USD	7.0	1.0	7.0	0.0	NA	NA	NA	NA	NA	NA	NA	7.0	0.0	1.05	1.35	0.0	7.18	7.18	5.95	digital download	NA	https://patternshift.bandcamp.com/album/fragments-of-the-fleet	NA	672985 458529	NA	United States	US	NA
8/12/20 8:15 PM	payout	NA	NA	USD	NA	NA	NA	NA	NA	NA	NA	NA	NA	0.07	transfer	7.18	7.11	NA	NA	NA	-7.18	0.0	NA	NA	NA	NA	NA	NA	NA	NA	NA	0.0
9/6/20 2:28 PM	album	Wake of the Wanderer	PatternShift	USD	10.0	1.0	10.0	0.0	NA	NA	NA	NA	NA	0.59	paypal	10.0	0.0	1.5	1.5	0.0	7.91	7.91	7.91	digital download	NA	https://patternshift.bandcamp.com/album/wake-of-the-wanderer	NA	628810 635399	NA	Canada	CA	NA
9/7/20 12:30 AM	album	Fragments of the Fleet	PatternShift	USD	10.0	1.0	10.0	0.0	NA	NA	NA	NA	NA	0.49	paypal	10.0	0.0	1.5	1.5	0.0	8.01	15.92	8.01	digital download	NA	https://patternshift.bandcamp.com/album/fragments-of-the-fleet	NA	672985 458529	NA	United States	US	NA
9/7/20 8:14 PM	payout	NA	NA	USD	NA	NA	NA	NA	NA	NA	NA	NA	NA	0.08	transfer	7.91	7.83	NA	NA	NA	-7.91	8.01	NA	NA	NA	NA	NA	NA	NA	NA	NA	0.0
9/8/20 8:14 PM	payout	NA	NA	USD	NA	NA	NA	NA	NA	NA	NA	NA	NA	0.08	transfer	8.01	7.93	NA	NA	NA	-8.01	0.0	NA	NA	NA	NA	NA	NA	NA	NA	NA	0.0
9/9/20 6:50 PM	album	PatternShift EP	PatternShift	USD	2.0	1.0	2.0	0.0	NA	NA	NA	NA	NA	0.25	credit card	2.0	0.0	0.3	0.0	0.3	0.0	0.0	1.45	digital download	NA	https://patternshift.bandcamp.com/album/patternshift-ep	NA	NA	NA	United States	US	NA
9/9/20 6:50 PM	album	Interoception	PatternShift	USD	2.0	1.0	2.0	0.0	NA	NA	NA	NA	NA	NA	NA	2.0	0.0	0.3	0.6	0.0	3.15	3.15	1.7	digital download	NA	https://patternshift.bandcamp.com/album/interoception	NA	NA	NA	United States	US	NA
9/10/20 8:15 PM	payout	NA	NA	USD	NA	NA	NA	NA	NA	NA	NA	NA	NA	0.03	transfer	3.15	3.12	NA	NA	NA	-3.15	0.0	NA	NA	NA	NA	NA	NA	NA	NA	NA	0.0
9/19/20 2:19 AM	album	Fragments of the Fleet	PatternShift	USD	18.0	1.0	18.0	0.0	NA	NA	NA	NA	NA	0.64	paypal	18.0	0.0	2.7	2.7	0.0	14.66	14.66	14.66	digital download	NA	https://patternshift.bandcamp.com/album/fragments-of-the-fleet	NA	672985 458529	NA	United States	US	NA
9/20/20 8:14 PM	payout	NA	NA	USD	NA	NA	NA	NA	NA	NA	NA	NA	NA	0.15	transfer	14.66	14.51	NA	NA	NA	-14.66	0.0	NA	NA	NA	NA	NA	NA	NA	NA	NA	0.0
11/7/20 12:47 AM	album	Rituals from the Distant Past, Memories from the Far Future	PatternShift	USD	1.0	1.0	1.0	0.0	NA	NA	NA	NA	NA	0.1	paypal	1.0	0.0	0.0	0.0	0.0	0.9	0.9	0.9	digital download	NA	https://patternshift.bandcamp.com/album/rituals-from-the-distant-past-memories-from-the-far-future	NA	628810 896967	NA	United States	US	NA
11/8/20 8:20 PM	payout	NA	NA	USD	NA	NA	NA	NA	NA	NA	NA	NA	NA	0.01	transfer	0.9	0.89	NA	NA	NA	-0.9	0.0	NA	NA	NA	NA	NA	NA	NA	NA	NA	0.0
12/27/20 1:54 PM	track	The Needle	PatternShift	USD	1.0	1.0	1.0	0.0	NA	NA	0.25	NA	NA	0.13	credit card	1.25	0.0	0.15	0.15	0.0	0.72	0.72	0.72	digital download	NA	https://patternshift.bandcamp.com/track/the-needle	NA	NA	CA-GOO-19-48130	Sweden	SE	NA
12/28/20 8:24 PM	payout	NA	NA	USD	NA	NA	NA	NA	NA	NA	NA	NA	NA	0.01	transfer	0.72	0.71	NA	NA	NA	-0.72	0.0	NA	NA	NA	NA	NA	NA	NA	NA	NA	0.0
1/7/21 8:26 PM	bundle	full digital discography (16 releases)	PatternShift	USD	30.0	1.0	30.0	0.0	NA	NA	NA	NA	NA	1.17	paypal	30.0	0.0	4.5	4.5	0.0	24.33	24.33	24.33	digital bundle	NA	https://patternshift.bandcamp.com	NA	NA	NA	Canada	CA	NA
1/9/21 8:25 PM	payout	NA	NA	USD	NA	NA	NA	NA	NA	NA	NA	NA	NA	0.24	transfer	24.33	24.09	NA	NA	NA	-24.33	0.0	NA	NA	NA	NA	NA	NA	NA	NA	NA	0.0
2/6/21 5:44 PM	album	Fragments of the Fleet	PatternShift	USD	7.0	1.0	7.0	0.0	24.0	NA	1.68	NA	NA	0.58	credit card	8.68	0.0	1.05	1.05	0.0	5.37	5.37	5.37	digital download	NA	https://patternshift.bandcamp.com/album/fragments-of-the-fleet	NA	672985 458529	NA	Finland	FI	NA
2/7/21 8:34 PM	payout	NA	NA	USD	NA	NA	NA	NA	NA	NA	NA	NA	NA	0.05	transfer	5.37	5.32	NA	NA	NA	-5.37	0.0	NA	NA	NA	NA	NA	NA	NA	NA	NA	0.0
2/8/21 7:37 PM	album	Fragments of the Fleet	PatternShift	USD	7.0	1.0	7.0	0.0	20.0	NA	1.4	NA	NA	0.57	credit card	8.4	0.0	1.05	1.05	0.0	5.38	5.38	5.38	digital download	NA	https://patternshift.bandcamp.com/album/fragments-of-the-fleet	NA	672985 458529	NA	United Kingdom	GB	NA
2/9/21 8:21 PM	payout	NA	NA	USD	NA	NA	NA	NA	NA	NA	NA	NA	NA	0.05	transfer	5.38	5.33	NA	NA	NA	-5.38	0.0	NA	NA	NA	NA	NA	NA	NA	NA	NA	0.0
2/19/21 3:13 PM	bundle	full digital discography (16 releases)	PatternShift	USD	32.0	1.0	32.0	0.0	NA	NA	NA	NA	NA	0.91	paypal	32.0	0.0	4.8	4.8	0.0	26.29	26.29	26.29	digital bundle	NA	https://patternshift.bandcamp.com	NA	NA	NA	Costa Rica	CR	NA
2/20/21 8:23 PM	payout	NA	NA	USD	NA	NA	NA	NA	NA	NA	NA	NA	NA	0.26	transfer	26.29	26.03	NA	NA	NA	-26.29	0.0	NA	NA	NA	NA	NA	NA	NA	NA	NA	0.0
3/26/21 5:23 PM	track	The Physical Option	PatternShift	USD	1.0	1.0	1.0	0.0	NA	NA	NA	NA	NA	0.1	paypal	1.0	0.0	0.15	0.15	0.0	0.75	0.75	0.75	digital download	NA	https://patternshift.bandcamp.com/track/the-physical-option	NA	NA	NA	Russia	RU	NA
3/27/21 8:24 PM	payout	NA	NA	USD	NA	NA	NA	NA	NA	NA	NA	NA	NA	0.01	transfer	0.75	0.74	NA	NA	NA	-0.75	0.0	NA	NA	NA	NA	NA	NA	NA	NA	NA	0.0
4/2/21 2:08 PM	album	Testament of the Earth Sage	PatternShift	USD	4.0	1.0	4.0	0.0	NA	NA	NA	NA	NA	0.25	credit card	4.0	0.0	0.0	0.0	0.0	3.75	3.75	3.75	digital download	NA	https://patternshift.bandcamp.com/album/testament-of-the-earth-sage	NA	672985 108011	NA	United States	US	NA
4/3/21 8:29 PM	payout	NA	NA	USD	NA	NA	NA	NA	NA	NA	NA	NA	NA	0.04	transfer	3.75	3.71	NA	NA	NA	-3.75	0.0	NA	NA	NA	NA	NA	NA	NA	NA	NA	0.0
4/30/21 1:05 AM	album	Exponent	PatternShift	USD	7.0	1.0	7.0	0.0	8.81	NA	0.62	NA	NA	0.43	credit card	7.62	0.0	1.05	1.05	0.0	5.52	5.52	5.52	digital download	NA	https://patternshift.bandcamp.com/album/exponent	NA	NA	NA	United States	US	NA
4/30/21 1:26 AM	album	Exponent	PatternShift	USD	7.0	1.0	7.0	0.0	8.52	NA	0.6	NA	NA	0.43	paypal	7.6	0.0	1.05	1.05	0.0	5.52	11.04	5.52	digital download	NA	https://patternshift.bandcamp.com/album/exponent	NA	NA	NA	United States	US	NA
4/30/21 9:23 AM	album	Exponent	PatternShift	USD	7.0	1.0	7.0	0.0	20.0	NA	1.4	NA	NA	0.54	paypal	8.4	0.0	1.05	1.05	0.0	5.41	16.45	5.41	digital download	NA	https://patternshift.bandcamp.com/album/exponent	NA	NA	NA	United Kingdom	GB	NA
4/30/21 10:44 PM	album	Exponent	PatternShift	USD	10.0	1.0	10.0	0.0	8.0	NA	0.56	NA	NA	0.5	paypal	10.56	0.0	1.5	1.5	0.0	8.0	24.45	8.0	digital download	NA	https://patternshift.bandcamp.com/album/exponent	NA	NA	NA	United States	US	NA
5/1/21 8:26 PM	payout	NA	NA	USD	NA	NA	NA	NA	NA	NA	NA	NA	NA	0.11	transfer	11.04	10.93	NA	NA	NA	-11.04	13.41	NA	NA	NA	NA	NA	NA	NA	NA	NA	0.0
5/1/21 8:26 PM	payout	NA	NA	USD	NA	NA	NA	NA	NA	NA	NA	NA	NA	0.05	transfer	5.41	5.36	NA	NA	NA	-5.41	8.0	NA	NA	NA	NA	NA	NA	NA	NA	NA	0.0
5/2/21 8:01 PM	album	New Worlds Born in Fire	PatternShift	USD	4.0	1.0	4.0	0.0	NA	NA	NA	NA	NA	0.25	credit card	4.0	0.0	0.6	0.6	0.0	3.15	11.15	3.15	digital download	NA	https://patternshift.bandcamp.com/album/new-worlds-born-in-fire	NA	NA	NA	United States	US	NA
5/2/21 8:26 PM	payout	NA	NA	USD	NA	NA	NA	NA	NA	NA	NA	NA	NA	0.08	transfer	8.0	7.92	NA	NA	NA	-8.0	3.15	NA	NA	NA	NA	NA	NA	NA	NA	NA	0.0
5/3/21 2:39 AM	track	Hypermorphic	PatternShift	USD	1.0	1.0	1.0	0.0	19.0	NA	0.19	NA	NA	0.12	credit card	1.19	0.0	0.15	0.15	0.0	0.73	3.88	0.73	digital download	NA	https://patternshift.bandcamp.com/track/hypermorphic-2	NA	NA	NA	Germany	DE	NA
5/3/21 8:26 PM	payout	NA	NA	USD	NA	NA	NA	NA	NA	NA	NA	NA	NA	0.03	transfer	3.15	3.12	NA	NA	NA	-3.15	0.73	NA	NA	NA	NA	NA	NA	NA	NA	NA	0.0
5/4/21 8:26 PM	payout	NA	NA	USD	NA	NA	NA	NA	NA	NA	NA	NA	NA	0.01	transfer	0.73	0.72	NA	NA	NA	-0.73	0.0	NA	NA	NA	NA	NA	NA	NA	NA	NA	0.0
5/6/21 6:10 PM	album	Exponent	PatternShift	USD	7.0	1.0	7.0	0.0	24.0	NA	1.68	NA	NA	0.58	credit card	8.68	0.0	1.05	1.05	0.0	5.37	5.37	5.37	digital download	NA	https://patternshift.bandcamp.com/album/exponent	NA	NA	NA	Finland	FI	NA
5/7/21 5:05 PM	bundle	full digital discography (17 releases)	PatternShift	USD	23.4	1.0	23.4	0.0	7.53	NA	1.76	NA	NA	0.78	paypal	25.16	0.0	0.0	0.0	0.0	22.62	27.99	22.62	digital bundle	NA	https://patternshift.bandcamp.com	NA	NA	NA	United States	US	NA
5/7/21 8:29 PM	payout	NA	NA	USD	NA	NA	NA	NA	NA	NA	NA	NA	NA	0.05	transfer	5.37	5.32	NA	NA	NA	-5.37	22.62	NA	NA	NA	NA	NA	NA	NA	NA	NA	0.0
5/8/21 8:31 PM	payout	NA	NA	USD	NA	NA	NA	NA	NA	NA	NA	NA	NA	0.23	transfer	22.62	22.39	NA	NA	NA	-22.62	0.0	NA	NA	NA	NA	NA	NA	NA	NA	NA	0.0
5/24/21 3:08 PM	album	Exponent	PatternShift	USD	15.0	1.0	15.0	0.0	NA	NA	NA	NA	NA	0.59	paypal	15.0	0.0	2.25	2.25	0.0	12.16	12.16	12.16	digital download	NA	https://patternshift.bandcamp.com/album/exponent	NA	NA	NA	United States	US	NA
5/25/21 8:26 PM	payout	NA	NA	USD	NA	NA	NA	NA	NA	NA	NA	NA	NA	0.12	transfer	12.16	12.04	NA	NA	NA	-12.16	0.0	NA	NA	NA	NA	NA	NA	NA	NA	NA	0.0
6/7/21 1:39 PM	album	Fragments of the Fleet	PatternShift	USD	7.0	1.0	7.0	0.0	NA	NA	NA	NA	NA	0.4	paypal	7.0	0.0	1.05	1.05	0.0	5.55	5.55	5.55	digital download	NA	https://patternshift.bandcamp.com/album/fragments-of-the-fleet	NA	672985 458529	NA	United States	US	NA
6/8/21 8:26 PM	payout	NA	NA	USD	NA	NA	NA	NA	NA	NA	NA	NA	NA	0.06	transfer	5.55	5.49	NA	NA	NA	-5.55	0.0	NA	NA	NA	NA	NA	NA	NA	NA	NA	0.0
6/13/21 3:32 AM	bundle	full digital discography (17 releases)	PatternShift	USD	24.0	1.0	24.0	0.0	NA	NA	NA	NA	NA	1.07	credit card	24.0	0.0	3.6	3.6	0.0	19.33	19.33	19.33	digital bundle	NA	https://patternshift.bandcamp.com	NA	NA	NA	Canada	CA	NA
6/13/21 3:40 AM	bundle	full digital discography (17 releases)	PatternShift	USD	23.4	1.0	23.4	0.0	23.0	NA	5.38	NA	NA	1.13	paypal	28.78	0.0	3.51	3.51	0.0	18.76	38.09	18.76	digital bundle	NA	https://patternshift.bandcamp.com	NA	NA	NA	Poland	PL	NA
6/14/21 4:35 PM	album	Exponent	PatternShift	USD	7.0	1.0	7.0	0.0	8.2	NA	0.57	NA	NA	0.43	credit card	7.57	0.0	1.05	1.05	0.0	5.52	43.61	5.52	digital download	NA	https://patternshift.bandcamp.com/album/exponent	NA	NA	NA	United States	US	NA
6/14/21 8:27 PM	payout	NA	NA	USD	NA	NA	NA	NA	NA	NA	NA	NA	NA	0.38	transfer	38.09	37.71	NA	NA	NA	-38.09	5.52	NA	NA	NA	NA	NA	NA	NA	NA	NA	0.0
6/15/21 3:47 PM	album	Exponent	PatternShift	USD	7.0	1.0	7.0	0.0	10.0	NA	0.7	NA	NA	0.51	credit card	7.7	0.0	1.05	1.05	0.0	5.44	10.96	5.44	digital download	NA	https://patternshift.bandcamp.com/album/exponent	NA	NA	NA	Australia	AU	NA
6/15/21 8:27 PM	payout	NA	NA	USD	NA	NA	NA	NA	NA	NA	NA	NA	NA	0.06	transfer	5.52	5.46	NA	NA	NA	-5.52	5.44	NA	NA	NA	NA	NA	NA	NA	NA	NA	0.0
6/16/21 8:26 PM	payout	NA	NA	USD	NA	NA	NA	NA	NA	NA	NA	NA	NA	0.05	transfer	5.44	5.39	NA	NA	NA	-5.44	0.0	NA	NA	NA	NA	NA	NA	NA	NA	NA	0.0
6/18/21 7:35 AM	album	Exponent	PatternShift	USD	7.0	1.0	7.0	0.0	NA	NA	NA	NA	NA	0.4	gift card	7.0	0.0	1.05	1.05	0.0	5.55	5.55	5.55	digital download	NA	https://patternshift.bandcamp.com/album/exponent	NA	NA	NA	United States	US	NA
6/18/21 6:20 PM	album	Exponent	PatternShift	USD	7.0	1.0	7.0	0.0	17.0	NA	1.19	NA	NA	0.56	credit card	8.19	0.0	1.05	1.05	0.0	5.39	10.94	5.39	digital download	NA	https://patternshift.bandcamp.com/album/exponent	NA	NA	NA	Luxembourg	LU	NA
6/19/21 8:28 PM	payout	NA	NA	USD	NA	NA	NA	NA	NA	NA	NA	NA	NA	0.11	transfer	10.94	10.83	NA	NA	NA	-10.94	0.0	NA	NA	NA	NA	NA	NA	NA	NA	NA	0.0
6/21/21 11:17 AM	track	Pulse Chase	PatternShift	USD	2.0	1.0	2.0	0.0	22.0	NA	0.22	NA	NA	0.18	credit card	2.22	0.0	0.3	0.3	0.0	1.52	1.52	1.52	digital download	NA	https://patternshift.bandcamp.com/track/pulse-chase	NA	NA	NA	Italy	IT	NA
6/22/21 8:27 PM	payout	NA	NA	USD	NA	NA	NA	NA	NA	NA	NA	NA	NA	0.02	transfer	1.52	1.5	NA	NA	NA	-1.52	0.0	NA	NA	NA	NA	NA	NA	NA	NA	NA	0.0
6/27/21 8:24 AM	album	Exponent	PatternShift	USD	7.0	1.0	7.0	0.0	20.0	NA	1.4	NA	NA	0.54	paypal	8.4	0.0	1.05	1.05	0.0	5.41	5.41	5.41	digital download	NA	https://patternshift.bandcamp.com/album/exponent	NA	NA	NA	United Kingdom	GB	NA
6/28/21 8:26 PM	payout	NA	NA	USD	NA	NA	NA	NA	NA	NA	NA	NA	NA	0.05	transfer	5.41	5.36	NA	NA	NA	-5.41	0.0	NA	NA	NA	NA	NA	NA	NA	NA	NA	0.0
8/20/21 8:31 PM	track	Change of Basis	PatternShift	USD	1.0	1.0	1.0	0.0	NA	NA	NA	NA	NA	0.1	credit card	1.0	0.0	0.15	0.15	0.0	0.75	0.75	0.75	digital download	NA	https://patternshift.bandcamp.com/track/change-of-basis	NA	NA	CA-GOO-19-96418	United States	US	NA
8/22/21 8:29 PM	payout	NA	NA	USD	NA	NA	NA	NA	NA	NA	NA	NA	NA	0.01	transfer	0.75	0.74	NA	NA	NA	-0.75	0.0	NA	NA	NA	NA	NA	NA	NA	NA	NA	0.0
8/27/21 8:16 AM	album	Fragments of the Fleet	PatternShift	USD	7.0	1.0	7.0	0.0	19.0	NA	1.33	NA	NA	0.57	credit card	8.33	0.0	1.05	1.05	0.0	5.38	5.38	5.38	digital download	NA	https://patternshift.bandcamp.com/album/fragments-of-the-fleet	NA	672985 458529	NA	Romania	RO	NA
8/28/21 8:30 PM	payout	NA	NA	USD	NA	NA	NA	NA	NA	NA	NA	NA	NA	0.05	transfer	5.38	5.33	NA	NA	NA	-5.38	0.0	NA	NA	NA	NA	NA	NA	NA	NA	NA	0.0
8/30/21 1:56 PM	album	Exponent	PatternShift	USD	7.0	1.0	7.0	0.0	15.0	NA	1.05	NA	NA	0.53	paypal	8.05	0.0	1.05	1.05	0.0	5.42	5.42	5.42	digital download	NA	https://patternshift.bandcamp.com/album/exponent	NA	NA	NA	Canada	CA	NA
8/31/21 8:30 PM	payout	NA	NA	USD	NA	NA	NA	NA	NA	NA	NA	NA	NA	0.05	transfer	5.42	5.37	NA	NA	NA	-5.42	0.0	NA	NA	NA	NA	NA	NA	NA	NA	NA	0.0
9/21/21 5:40 PM	track	Change of Basis	PatternShift	USD	1.0	1.0	1.0	0.0	20.0	NA	0.2	NA	NA	0.12	credit card	1.2	0.0	0.15	0.15	0.0	0.73	0.73	0.73	digital download	NA	https://patternshift.bandcamp.com/track/change-of-basis	NA	NA	CA-GOO-19-96418	France	FR	NA
9/22/21 8:30 PM	payout	NA	NA	USD	NA	NA	NA	NA	NA	NA	NA	NA	NA	0.01	transfer	0.73	0.72	NA	NA	NA	-0.73	0.0	NA	NA	NA	NA	NA	NA	NA	NA	NA	0.0
10/15/21 4:59 PM	album	Fragments of the Fleet	PatternShift	USD	7.0	1.0	7.0	0.0	NA	NA	NA	NA	NA	0.4	credit card	7.0	0.0	1.05	1.05	0.0	5.55	5.55	5.55	digital download	NA	https://patternshift.bandcamp.com/album/fragments-of-the-fleet	NA	672985 458529	NA	United States	US	NA
10/16/21 8:33 PM	payout	NA	NA	USD	NA	NA	NA	NA	NA	NA	NA	NA	NA	0.06	transfer	5.55	5.49	NA	NA	NA	-5.55	0.0	NA	NA	NA	NA	NA	NA	NA	NA	NA	0.0
10/24/21 8:06 PM	track	Low Gravity Judo	PatternShift	USD	1.0	1.0	1.0	0.0	5.5	NA	0.06	NA	NA	0.1	credit card	1.06	0.0	0.15	0.15	0.0	0.75	0.75	0.75	digital download	NA	https://patternshift.bandcamp.com/track/low-gravity-judo	NA	NA	CA-HQJ-18-85077	United States	US	NA
10/25/21 8:32 PM	payout	NA	NA	USD	NA	NA	NA	NA	NA	NA	NA	NA	NA	0.01	transfer	0.75	0.74	NA	NA	NA	-0.75	0.0	NA	NA	NA	NA	NA	NA	NA	NA	NA	0.0
1/4/22 4:17 AM	track	Change of Basis	PatternShift	USD	1.0	1.0	1.0	0.0	19.0	NA	0.19	NA	NA	0.41	paypal	1.19	0.0	0.15	0.0	0.15	0.0	0.0	0.44	digital download	NA	https://patternshift.bandcamp.com/track/change-of-basis	NA	NA	CA-GOO-19-96418	Germany	DE	NA
1/4/22 4:17 AM	track	Echoes Before Our Kind	PatternShift	USD	1.0	1.0	1.0	0.0	19.0	NA	0.19	NA	NA	NA	NA	1.19	0.0	0.15	0.0	0.3	0.0	0.0	0.85	digital download	NA	https://patternshift.bandcamp.com/track/echoes-before-our-kind	NA	NA	CA-HQJ-18-85076	Germany	DE	NA
1/4/22 4:17 AM	track	Our Children Are Strangers	PatternShift	USD	1.0	1.0	1.0	0.0	19.0	NA	0.19	NA	NA	NA	NA	1.19	0.0	0.15	0.0	0.45	0.0	0.0	0.85	digital download	NA	https://patternshift.bandcamp.com/track/our-children-are-strangers	NA	NA	NA	Germany	DE	NA
1/4/22 4:17 AM	track	Elitsa's Quest	PatternShift	USD	1.0	1.0	1.0	0.0	19.0	NA	0.19	NA	NA	NA	NA	1.19	0.0	0.15	0.0	0.6	0.0	0.0	0.85	digital download	NA	https://patternshift.bandcamp.com/track/elitsas-quest	NA	NA	NA	Germany	DE	NA
1/4/22 4:17 AM	track	Last Rites	PatternShift	USD	1.0	1.0	1.0	0.0	19.0	NA	0.19	NA	NA	NA	NA	1.19	0.0	0.15	0.75	0.0	3.84	3.84	0.85	digital download	NA	https://patternshift.bandcamp.com/track/last-rites	NA	NA	CA-CWV-19-49278	Germany	DE	NA
1/5/22 8:36 PM	payout	NA	NA	USD	NA	NA	NA	NA	NA	NA	NA	NA	NA	0.04	transfer	3.84	3.8	NA	NA	NA	-3.84	0.0	NA	NA	NA	NA	NA	NA	NA	NA	NA	0.0
1/16/22 11:00 PM	album	Other Oceans	PatternShift	USD	7.0	1.0	7.0	0.0	8.2	NA	0.57	NA	NA	0.43	credit card	7.57	0.0	1.05	1.05	0.0	5.52	5.52	5.52	digital download	NA	https://patternshift.bandcamp.com/album/other-oceans	NA	859753 135305	NA	United States	US	NA
1/16/22 11:13 PM	track	Interoception	PatternShift	USD	1.0	1.0	1.0	0.0	7.88	NA	0.08	NA	NA	0.1	paypal	1.08	0.0	0.15	0.15	0.0	0.75	6.27	0.75	digital download	NA	https://patternshift.bandcamp.com/track/interoception-2	NA	NA	CA-ENV-20-23034	United States	US	NA
1/16/22 11:33 PM	album	Other Oceans	PatternShift	USD	7.0	1.0	7.0	0.0	8.81	NA	0.62	NA	NA	0.43	credit card	7.62	0.0	1.05	1.05	0.0	5.52	11.79	5.52	digital download	NA	https://patternshift.bandcamp.com/album/other-oceans	NA	859753 135305	NA	United States	US	NA
1/17/22 10:25 AM	album	Other Oceans	PatternShift	USD	10.0	1.0	10.0	0.0	5.5	NA	0.39	NA	NA	0.36	credit card	10.39	0.0	1.5	1.5	0.0	8.14	19.93	8.14	digital download	NA	https://patternshift.bandcamp.com/album/other-oceans	NA	859753 135305	NA	United States	US	NA
1/18/22 5:40 PM	album	Other Oceans	PatternShift	USD	7.0	1.0	7.0	0.0	19.0	NA	1.33	NA	NA	0.54	paypal	8.33	0.0	1.05	1.05	0.0	5.41	25.34	5.41	digital download	NA	https://patternshift.bandcamp.com/album/other-oceans	NA	859753 135305	NA	Germany	DE	NA
1/18/22 8:37 PM	payout	NA	NA	USD	NA	NA	NA	NA	NA	NA	NA	NA	NA	0.12	transfer	11.79	11.67	NA	NA	NA	-11.79	13.55	NA	NA	NA	NA	NA	NA	NA	NA	NA	0.0
1/18/22 8:37 PM	payout	NA	NA	USD	NA	NA	NA	NA	NA	NA	NA	NA	NA	0.08	transfer	8.14	8.06	NA	NA	NA	-8.14	5.41	NA	NA	NA	NA	NA	NA	NA	NA	NA	0.0
1/19/22 4:12 PM	album	Wake of the Wanderer	PatternShift	USD	8.0	1.0	8.0	0.0	8.2	NA	0.66	NA	NA	0.49	credit card	8.66	0.0	1.2	1.2	0.0	6.31	11.72	6.31	digital download	NA	https://patternshift.bandcamp.com/album/wake-of-the-wanderer	NA	628810 635399	NA	United States	US	NA
1/19/22 8:36 PM	payout	NA	NA	USD	NA	NA	NA	NA	NA	NA	NA	NA	NA	0.05	transfer	5.41	5.36	NA	NA	NA	-5.41	6.31	NA	NA	NA	NA	NA	NA	NA	NA	NA	0.0
1/20/22 8:37 PM	payout	NA	NA	USD	NA	NA	NA	NA	NA	NA	NA	NA	NA	0.06	transfer	6.31	6.25	NA	NA	NA	-6.31	0.0	NA	NA	NA	NA	NA	NA	NA	NA	NA	0.0
1/21/22 6:32 PM	album	Other Oceans	PatternShift	USD	15.0	1.0	15.0	0.0	NA	NA	NA	NA	NA	0.59	paypal	15.0	0.0	2.25	2.25	0.0	12.16	12.16	12.16	digital download	NA	https://patternshift.bandcamp.com/album/other-oceans	NA	859753 135305	NA	United States	US	NA
1/22/22 8:37 PM	payout	NA	NA	USD	NA	NA	NA	NA	NA	NA	NA	NA	NA	0.12	transfer	12.16	12.04	NA	NA	NA	-12.16	0.0	NA	NA	NA	NA	NA	NA	NA	NA	NA	0.0
1/25/22 6:36 AM	album	Other Oceans	PatternShift	USD	20.0	1.0	20.0	0.0	7.7	NA	0.54	NA	NA	0.75	credit card	20.54	0.0	3.0	3.0	0.0	16.25	16.25	16.25	digital download	NA	https://patternshift.bandcamp.com/album/other-oceans	NA	859753 135305	NA	United States	US	NA
1/26/22 8:35 PM	payout	NA	NA	USD	NA	NA	NA	NA	NA	NA	NA	NA	NA	0.16	transfer	16.25	16.09	NA	NA	NA	-16.25	0.0	NA	NA	NA	NA	NA	NA	NA	NA	NA	0.0
2/1/22 7:32 AM	track	Failed Star	PatternShift	USD	1.0	1.0	1.0	0.0	10.25	NA	0.1	NA	NA	0.11	credit card	1.1	0.0	0.15	0.15	0.0	0.74	0.74	0.74	digital download	NA	https://patternshift.bandcamp.com/track/failed-star	NA	NA	NA	United States	US	NA
2/2/22 12:16 AM	track	Failed Star	PatternShift	USD	1.0	1.0	1.0	0.0	8.25	NA	0.08	NA	NA	0.1	credit card	1.08	0.0	0.15	0.15	0.0	0.75	1.49	0.75	digital download	NA	https://patternshift.bandcamp.com/track/failed-star	NA	NA	NA	United States	US	NA
2/2/22 8:37 PM	payout	NA	NA	USD	NA	NA	NA	NA	NA	NA	NA	NA	NA	0.01	transfer	0.74	0.73	NA	NA	NA	-0.74	0.75	NA	NA	NA	NA	NA	NA	NA	NA	NA	0.0
2/3/22 8:38 PM	payout	NA	NA	USD	NA	NA	NA	NA	NA	NA	NA	NA	NA	0.01	transfer	0.75	0.74	NA	NA	NA	-0.75	0.0	NA	NA	NA	NA	NA	NA	NA	NA	NA	0.0
2/11/22 3:29 PM	album	Other Oceans	PatternShift	USD	7.0	1.0	7.0	0.0	20.0	NA	1.4	NA	NA	0.57	credit card	8.4	0.0	1.05	1.05	0.0	5.38	5.38	5.38	digital download	NA	https://patternshift.bandcamp.com/album/other-oceans	NA	859753 135305	NA	United Kingdom	GB	NA
2/12/22 8:36 PM	payout	NA	NA	USD	NA	NA	NA	NA	NA	NA	NA	NA	NA	0.05	transfer	5.38	5.33	NA	NA	NA	-5.38	0.0	NA	NA	NA	NA	NA	NA	NA	NA	NA	0.0
2/13/22 6:11 AM	album	Vaskania Prime	PatternShift	USD	6.0	1.0	6.0	0.0	NA	NA	NA	NA	NA	0.35	paypal	6.0	0.0	0.9	0.9	0.0	4.75	4.75	4.75	digital download	NA	https://patternshift.bandcamp.com/album/vaskania-prime	NA	800739 819641	NA	United States	US	NA
2/14/22 8:37 PM	payout	NA	NA	USD	NA	NA	NA	NA	NA	NA	NA	NA	NA	0.05	transfer	4.75	4.7	NA	NA	NA	-4.75	0.0	NA	NA	NA	NA	NA	NA	NA	NA	NA	0.0
2/22/22 12:07 AM	album	Other Oceans	PatternShift	USD	7.0	1.0	7.0	0.0	8.25	NA	0.58	NA	NA	0.43	credit card	7.58	0.0	1.05	1.05	0.0	5.52	5.52	5.52	digital download	NA	https://patternshift.bandcamp.com/album/other-oceans	NA	859753 135305	NA	United States	US	NA
2/23/22 8:38 PM	payout	NA	NA	USD	NA	NA	NA	NA	NA	NA	NA	NA	NA	0.06	transfer	5.52	5.46	NA	NA	NA	-5.52	0.0	NA	NA	NA	NA	NA	NA	NA	NA	NA	0.0
3/4/22 4:56 PM	album	Other Oceans	PatternShift	USD	7.0	1.0	7.0	0.0	24.0	NA	1.68	NA	NA	1.04	credit card	8.68	0.0	0.0	0.0	0.0	0.0	0.0	5.96	digital download	NA	https://patternshift.bandcamp.com/album/other-oceans	NA	859753 135305	NA	Finland	FI	NA
3/4/22 4:56 PM	album	New Worlds Born in Fire	PatternShift	USD	1.0	1.0	1.0	0.0	NA	NA	NA	NA	NA	NA	NA	1.0	0.0	0.0	0.0	0.0	0.0	0.0	1.0	digital download	NA	https://patternshift.bandcamp.com/album/new-worlds-born-in-fire	NA	NA	NA	Finland	FI	NA
3/4/22 4:56 PM	album	Seasons of Senescence	PatternShift	USD	1.0	1.0	1.0	0.0	NA	NA	NA	NA	NA	NA	NA	1.0	0.0	0.0	0.0	0.0	0.0	0.0	1.0	digital download	NA	https://patternshift.bandcamp.com/album/seasons-of-senescence	NA	672985 507265	NA	Finland	FI	NA
3/4/22 4:56 PM	album	Interoception	PatternShift	USD	2.0	1.0	2.0	0.0	24.0	NA	0.48	NA	NA	NA	NA	2.48	0.0	0.0	0.0	0.0	0.0	0.0	2.0	digital download	NA	https://patternshift.bandcamp.com/album/interoception	NA	NA	NA	Finland	FI	NA
3/4/22 4:56 PM	album	Wake of the Wanderer	PatternShift	USD	8.0	1.0	8.0	0.0	24.0	NA	1.92	NA	NA	NA	NA	9.92	0.0	0.0	0.0	0.0	17.96	17.96	8.0	digital download	NA	https://patternshift.bandcamp.com/album/wake-of-the-wanderer	NA	628810 635399	NA	Finland	FI	NA
3/4/22 5:21 PM	album	Other Oceans	PatternShift	USD	7.0	1.0	7.0	0.0	10.25	NA	0.72	NA	NA	0.44	paypal	7.72	0.0	0.0	0.0	0.0	6.56	24.52	6.56	digital download	NA	https://patternshift.bandcamp.com/album/other-oceans	NA	859753 135305	NA	United States	US	NA
3/5/22 12:08 PM	bundle	full digital discography (18 releases)	PatternShift	USD	30.0	1.0	30.0	0.0	20.0	NA	5.59	NA	NA	1.33	paypal	35.59	0.0	4.5	4.5	0.0	24.17	48.69	24.17	digital bundle	NA	https://patternshift.bandcamp.com	NA	NA	NA	France	FR	NA
3/5/22 8:42 PM	payout	NA	NA	USD	NA	NA	NA	NA	NA	NA	NA	NA	NA	0.18	transfer	17.96	17.78	NA	NA	NA	-17.96	30.73	NA	NA	NA	NA	NA	NA	NA	NA	NA	0.0
3/5/22 8:42 PM	payout	NA	NA	USD	NA	NA	NA	NA	NA	NA	NA	NA	NA	0.07	transfer	6.56	6.49	NA	NA	NA	-6.56	24.17	NA	NA	NA	NA	NA	NA	NA	NA	NA	0.0
3/6/22 8:41 PM	payout	NA	NA	USD	NA	NA	NA	NA	NA	NA	NA	NA	NA	0.24	transfer	24.17	23.93	NA	NA	NA	-24.17	0.0	NA	NA	NA	NA	NA	NA	NA	NA	NA	0.0
3/19/22 3:10 PM	album	Other Oceans	PatternShift	USD	7.0	1.0	7.0	0.0	8.25	NA	0.58	NA	NA	0.43	paypal	7.58	0.0	1.05	1.05	0.0	5.52	5.52	5.52	digital download	NA	https://patternshift.bandcamp.com/album/other-oceans	NA	859753 135305	NA	United States	US	NA
3/20/22 8:39 PM	payout	NA	NA	USD	NA	NA	NA	NA	NA	NA	NA	NA	NA	0.06	transfer	5.52	5.46	NA	NA	NA	-5.52	0.0	NA	NA	NA	NA	NA	NA	NA	NA	NA	0.0
4/1/22 2:47 PM	album	Rites of the Renouncer	PatternShift	USD	12.0	1.0	12.0	0.0	NA	NA	NA	NA	NA	0.53	paypal	12.0	0.0	0.0	0.0	0.0	11.47	11.47	11.47	digital download	NA	https://patternshift.bandcamp.com/album/rites-of-the-renouncer	NA	628810 138654	NA	United States	US	NA
4/2/22 8:43 PM	payout	NA	NA	USD	NA	NA	NA	NA	NA	NA	NA	NA	NA	0.11	transfer	11.47	11.36	NA	NA	NA	-11.47	0.0	NA	NA	NA	NA	NA	NA	NA	NA	NA	0.0
4/16/22 7:52 PM	bundle	full digital discography (18 releases)	PatternShift	USD	30.0	1.0	30.0	0.0	8.0	NA	2.24	NA	NA	0.91	paypal	32.24	0.0	4.5	4.5	0.0	24.59	24.59	24.59	digital bundle	NA	https://patternshift.bandcamp.com	NA	NA	NA	United States	US	NA
4/17/22 9:00 PM	payout	NA	NA	USD	NA	NA	NA	NA	NA	NA	NA	NA	NA	0.25	transfer	24.59	24.34	NA	NA	NA	-24.59	0.0	NA	NA	NA	NA	NA	NA	NA	NA	NA	0.0
4/27/22 9:18 PM	track	Quiet Storms	PatternShift	USD	1.0	1.0	1.0	0.0	20.0	NA	0.2	NA	NA	0.12	paypal	1.2	0.0	0.15	0.15	0.0	0.73	0.73	0.73	digital download	NA	https://patternshift.bandcamp.com/track/quiet-storms-2	NA	NA	CA-CWV-21-10711	United Kingdom	GB	NA
4/29/22 9:03 PM	payout	NA	NA	USD	NA	NA	NA	NA	NA	NA	NA	NA	NA	0.01	transfer	0.73	0.72	NA	NA	NA	-0.73	0.0	NA	NA	NA	NA	NA	NA	NA	NA	NA	0.0
5/5/22 4:31 PM	track	Cities I'll Never See	PatternShift	USD	1.0	1.0	1.0	0.0	NA	NA	NA	NA	NA	0.1	credit card	1.0	0.0	0.15	0.15	0.0	0.75	0.75	0.75	digital download	NA	https://patternshift.bandcamp.com/track/cities-ill-never-see	NA	NA	NA	Singapore	SG	NA
5/6/22 8:40 PM	payout	NA	NA	USD	NA	NA	NA	NA	NA	NA	NA	NA	NA	0.01	transfer	0.75	0.74	NA	NA	NA	-0.75	0.0	NA	NA	NA	NA	NA	NA	NA	NA	NA	0.0
5/6/22 10:41 PM	album	Other Oceans	PatternShift	USD	7.0	1.0	7.0	0.0	2.9	NA	0.2	NA	NA	0.41	credit card	7.2	0.0	0.0	0.0	0.0	6.59	6.59	6.59	digital download	NA	https://patternshift.bandcamp.com/album/other-oceans	NA	859753 135305	NA	United States	US	NA
5/8/22 8:36 PM	payout	NA	NA	USD	NA	NA	NA	NA	NA	NA	NA	NA	NA	0.07	transfer	6.59	6.52	NA	NA	NA	-6.59	0.0	NA	NA	NA	NA	NA	NA	NA	NA	NA	0.0
5/17/22 10:14 AM	album	Other Oceans	PatternShift	USD	7.0	1.0	7.0	0.0	22.0	NA	1.54	NA	NA	0.55	paypal	8.54	0.0	1.05	1.05	0.0	5.4	5.4	5.4	digital download	NA	https://patternshift.bandcamp.com/album/other-oceans	NA	859753 135305	NA	Italy	IT	NA
5/18/22 8:20 PM	payout	NA	NA	USD	NA	NA	NA	NA	NA	NA	NA	NA	NA	0.05	transfer	5.4	5.35	NA	NA	NA	-5.4	0.0	NA	NA	NA	NA	NA	NA	NA	NA	NA	0.0
6/23/22 11:23 PM	track	Exsurgent	PatternShift	USD	1.0	1.0	1.0	0.0	NA	NA	NA	NA	NA	0.11	credit card	1.0	0.0	0.15	0.15	0.0	0.74	0.74	0.74	digital download	NA	https://patternshift.bandcamp.com/track/exsurgent	NA	NA	NA	Switzerland	CH	NA
6/25/22 7:17 PM	payout	NA	NA	USD	NA	NA	NA	NA	NA	NA	NA	NA	NA	0.01	transfer	0.74	0.73	NA	NA	NA	-0.74	0.0	NA	NA	NA	NA	NA	NA	NA	NA	NA	0.0
7/6/22 11:44 AM	album	Wake of the Wanderer	PatternShift	USD	8.0	1.0	8.0	0.0	20.0	NA	1.6	NA	NA	0.61	credit card	9.6	0.0	1.2	1.2	0.0	6.19	6.19	6.19	digital download	NA	https://patternshift.bandcamp.com/album/wake-of-the-wanderer	NA	628810 635399	NA	France	FR	NA
7/7/22 7:18 PM	payout	NA	NA	USD	NA	NA	NA	NA	NA	NA	NA	NA	NA	0.06	transfer	6.19	6.13	NA	NA	NA	-6.19	0.0	NA	NA	NA	NA	NA	NA	NA	NA	NA	0.0
7/19/22 11:24 AM	track	Low Gravity Judo	PatternShift	USD	1.0	1.0	1.0	0.0	6.0	NA	0.06	NA	NA	0.1	paypal	1.06	0.0	0.15	0.15	0.0	0.75	0.75	0.75	digital download	NA	https://patternshift.bandcamp.com/track/low-gravity-judo	NA	NA	CA-HQJ-18-85077	United States	US	NA
7/20/22 7:17 PM	payout	NA	NA	USD	NA	NA	NA	NA	NA	NA	NA	NA	NA	0.01	transfer	0.75	0.74	NA	NA	NA	-0.75	0.0	NA	NA	NA	NA	NA	NA	NA	NA	NA	0.0
11/4/22 12:55 AM	album	Testament of the Earth Sage	PatternShift	USD	0.0	1.0	0.0	3.0	NA	NA	NA	NA	NA	0.2	paypal	3.0	0.0	0.45	0.45	0.0	2.35	2.35	2.35	digital download	NA	https://patternshift.bandcamp.com/album/testament-of-the-earth-sage	NA	672985 108011	NA	United States	US	NA
11/4/22 12:04 PM	album	Vaskania Prime	PatternShift	USD	6.0	1.0	6.0	0.0	25.0	NA	1.5	NA	NA	0.5	credit card	7.5	0.0	0.0	0.0	0.0	5.5	7.85	5.5	digital download	NA	https://patternshift.bandcamp.com/album/vaskania-prime	NA	800739 819641	NA	Sweden	SE	NA
11/5/22 7:23 PM	payout	NA	NA	USD	NA	NA	NA	NA	NA	NA	NA	NA	NA	0.08	transfer	7.85	7.77	NA	NA	NA	-7.85	0.0	NA	NA	NA	NA	NA	NA	NA	NA	NA	0.0
12/29/22 5:41 PM	track	Low Gravity Judo	PatternShift	USD	1.0	1.0	1.0	0.0	NA	NA	NA	NA	NA	0.1	gift card	1.0	0.0	0.15	0.15	0.0	0.75	0.75	0.75	digital download	NA	https://patternshift.bandcamp.com/track/low-gravity-judo	NA	NA	CA-HQJ-18-85077	Japan	JP	NA
12/30/22 7:24 PM	payout	NA	NA	USD	NA	NA	NA	NA	NA	NA	NA	NA	NA	0.01	transfer	0.75	0.74	NA	NA	NA	-0.75	0.0	NA	NA	NA	NA	NA	NA	NA	NA	NA	0.0
1/28/23 4:39 AM	album	Cycles	Mnemonurgos	USD	7.0	1.0	7.0	0.0	5.13	NA	0.36	NA	NA	0.42	credit card	7.36	0.0	1.05	1.05	0.0	5.53	5.53	5.53	digital download	NA	https://patternshift.bandcamp.com/album/cycles	NA	859768 871588	NA	United States	US	NA
1/29/23 7:24 PM	payout	NA	NA	USD	NA	NA	NA	NA	NA	NA	NA	NA	NA	0.06	transfer	5.53	5.47	NA	NA	NA	-5.53	0.0	NA	NA	NA	NA	NA	NA	NA	NA	NA	0.0
2/7/23 6:44 AM	album	Rituals from the Distant Past, Memories from the Far Future	PatternShift	USD	0.0	1.0	0.0	1.0	NA	NA	NA	NA	NA	0.1	paypal	1.0	0.0	0.15	0.15	0.0	0.75	0.75	0.75	digital download	NA	https://patternshift.bandcamp.com/album/rituals-from-the-distant-past-memories-from-the-far-future	NA	628810 896967	NA	United States	US	NA
2/8/23 7:23 PM	payout	NA	NA	USD	NA	NA	NA	NA	NA	NA	NA	NA	NA	0.01	transfer	0.75	0.74	NA	NA	NA	-0.75	0.0	NA	NA	NA	NA	NA	NA	NA	NA	NA	0.0
2/16/23 9:15 PM	album	Other Oceans	PatternShift	USD	7.0	1.0	7.0	0.0	NA	NA	NA	NA	NA	0.4	paypal	7.0	0.0	1.05	1.05	0.0	5.55	5.55	5.55	digital download	NA	https://patternshift.bandcamp.com/album/other-oceans	NA	859753 135305	NA	United States	US	NA
2/18/23 7:26 PM	payout	NA	NA	USD	NA	NA	NA	NA	NA	NA	NA	NA	NA	0.06	transfer	5.55	5.49	NA	NA	NA	-5.55	0.0	NA	NA	NA	NA	NA	NA	NA	NA	NA	0.0
4/8/23 12:03 AM	album	Cascade	PatternShift	USD	7.0	1.0	7.0	0.0	5.13	NA	0.36	NA	NA	0.42	credit card	7.36	0.0	0.0	0.0	0.0	6.58	6.58	6.58	digital download	NA	https://patternshift.bandcamp.com/album/cascade	NA	197746 983930	NA	United States	US	NA
4/8/23 1:21 PM	album	Cascade	PatternShift	USD	7.0	1.0	7.0	8.0	6.0	NA	0.42	NA	NA	0.59	paypal	15.42	0.0	2.25	2.25	0.0	12.16	18.74	12.16	digital download	NA	https://patternshift.bandcamp.com/album/cascade	NA	197746 983930	NA	United States	US	NA
4/9/23 4:14 PM	track	Heat Shock Response	PatternShift	USD	1.0	1.0	1.0	0.0	19.0	NA	0.19	NA	NA	0.12	paypal	1.19	0.0	0.15	0.15	0.0	0.73	19.47	0.73	digital download	NA	https://patternshift.bandcamp.com/track/heat-shock-response	NA	NA	NA	Germany	DE	NA
4/9/23 4:31 PM	album	Cascade	PatternShift	USD	7.0	1.0	7.0	0.0	5.19	NA	0.36	NA	NA	0.42	credit card	7.36	0.0	1.05	1.05	0.0	5.53	25.0	5.53	digital download	NA	https://patternshift.bandcamp.com/album/cascade	NA	197746 983930	NA	United States	US	NA
4/9/23 7:25 PM	payout	NA	NA	USD	NA	NA	NA	NA	NA	NA	NA	NA	NA	0.07	transfer	6.58	6.51	NA	NA	NA	-6.58	18.42	NA	NA	NA	NA	NA	NA	NA	NA	NA	0.0
4/9/23 7:25 PM	payout	NA	NA	USD	NA	NA	NA	NA	NA	NA	NA	NA	NA	0.12	transfer	12.16	12.04	NA	NA	NA	-12.16	6.26	NA	NA	NA	NA	NA	NA	NA	NA	NA	0.0
4/10/23 2:03 PM	album	Cascade	PatternShift	USD	7.0	1.0	7.0	3.0	NA	NA	NA	NA	NA	0.49	paypal	10.0	0.0	1.5	1.5	0.0	8.01	14.27	8.01	digital download	NA	https://patternshift.bandcamp.com/album/cascade	NA	197746 983930	NA	United States	US	NA
4/10/23 7:23 PM	payout	NA	NA	USD	NA	NA	NA	NA	NA	NA	NA	NA	NA	0.06	transfer	6.26	6.2	NA	NA	NA	-6.26	8.01	NA	NA	NA	NA	NA	NA	NA	NA	NA	0.0
4/11/23 7:23 PM	payout	NA	NA	USD	NA	NA	NA	NA	NA	NA	NA	NA	NA	0.08	transfer	8.01	7.93	NA	NA	NA	-8.01	0.0	NA	NA	NA	NA	NA	NA	NA	NA	NA	0.0
4/20/23 2:32 PM	track	Loss of Function	PatternShift	USD	1.0	1.0	1.0	0.0	19.0	NA	0.19	NA	NA	0.12	paypal	1.19	0.0	0.15	0.15	0.0	0.73	0.73	0.73	digital download	NA	https://patternshift.bandcamp.com/track/loss-of-function-2	NA	NA	NA	Germany	DE	NA
4/21/23 7:26 PM	payout	NA	NA	USD	NA	NA	NA	NA	NA	NA	NA	NA	NA	0.01	transfer	0.73	0.72	NA	NA	NA	-0.73	0.0	NA	NA	NA	NA	NA	NA	NA	NA	NA	0.0
5/1/23 11:27 PM	album	Cascade	PatternShift	USD	7.0	1.0	7.0	0.0	8.81	NA	0.62	NA	NA	0.43	paypal	7.62	0.0	1.05	1.05	0.0	5.52	5.52	5.52	digital download	NA	https://patternshift.bandcamp.com/album/cascade	NA	197746 983930	NA	United States	US	NA
5/3/23 7:25 PM	payout	NA	NA	USD	NA	NA	NA	NA	NA	NA	NA	NA	NA	0.06	transfer	5.52	5.46	NA	NA	NA	-5.52	0.0	NA	NA	NA	NA	NA	NA	NA	NA	NA	0.0
5/27/23 9:54 AM	track	The Space Between Stars	PatternShift	USD	1.0	1.0	1.0	0.0	NA	NA	NA	NA	NA	0.1	credit card	1.0	0.0	0.15	0.15	0.0	0.75	0.75	0.75	digital download	NA	https://patternshift.bandcamp.com/track/the-space-between-stars	NA	NA	NA	United States	US	NA
5/28/23 7:26 PM	payout	NA	NA	USD	NA	NA	NA	NA	NA	NA	NA	NA	NA	0.01	transfer	0.75	0.74	NA	NA	NA	-0.75	0.0	NA	NA	NA	NA	NA	NA	NA	NA	NA	0.0
6/15/23 2:44 PM	album	Cascade	PatternShift	USD	7.0	1.0	7.0	0.0	24.0	NA	1.68	NA	NA	0.58	credit card	8.68	0.0	1.05	1.05	0.0	5.37	5.37	5.37	digital download	NA	https://patternshift.bandcamp.com/album/cascade	NA	197746 983930	NA	Finland	FI	NA
6/16/23 7:25 PM	payout	NA	NA	USD	NA	NA	NA	NA	NA	NA	NA	NA	NA	0.05	transfer	5.37	5.32	NA	NA	NA	-5.37	0.0	NA	NA	NA	NA	NA	NA	NA	NA	NA	0.0
7/18/23 6:26 PM	track	Cities I'll Never See	PatternShift	USD	1.0	1.0	1.0	0.0	20.0	NA	0.2	NA	NA	0.12	paypal	1.2	0.0	0.15	0.15	0.0	0.73	0.73	0.73	digital download	NA	https://patternshift.bandcamp.com/track/cities-ill-never-see	NA	NA	NA	United Kingdom	GB	NA
7/19/23 7:25 PM	payout	NA	NA	USD	NA	NA	NA	NA	NA	NA	NA	NA	NA	0.01	transfer	0.73	0.72	NA	NA	NA	-0.73	0.0	NA	NA	NA	NA	NA	NA	NA	NA	NA	0.0
7/20/23 9:20 PM	album	Cascade	PatternShift	USD	7.0	1.0	7.0	0.0	20.0	NA	1.4	NA	NA	0.54	paypal	8.4	0.0	1.05	1.05	0.0	5.41	5.41	5.41	digital download	NA	https://patternshift.bandcamp.com/album/cascade	NA	197746 983930	NA	United Kingdom	GB	NA
7/22/23 7:25 PM	payout	NA	NA	USD	NA	NA	NA	NA	NA	NA	NA	NA	NA	0.05	transfer	5.41	5.36	NA	NA	NA	-5.41	0.0	NA	NA	NA	NA	NA	NA	NA	NA	NA	0.0
8/18/23 10:22 AM	track	Interoception	PatternShift	USD	1.0	1.0	1.0	0.0	19.0	NA	0.19	NA	NA	0.19	credit card	1.19	0.0	0.15	0.0	0.15	0.0	0.0	0.66	digital download	NA	https://patternshift.bandcamp.com/track/interoception	NA	NA	NA	Germany	DE	NA
8/18/23 10:22 AM	track	Ice V	PatternShift	USD	1.0	1.0	1.0	0.0	19.0	NA	0.19	NA	NA	NA	NA	1.19	0.0	0.15	0.3	0.0	1.51	1.51	0.85	digital download	NA	https://patternshift.bandcamp.com/track/ice-v-2	NA	NA	CA-GOO-21-46775	Germany	DE	NA
8/19/23 7:32 PM	payout	NA	NA	USD	NA	NA	NA	NA	NA	NA	NA	NA	NA	0.02	transfer	1.51	1.49	NA	NA	NA	-1.51	0.0	NA	NA	NA	NA	NA	NA	NA	NA	NA	0.0
9/3/23 3:25 AM	album	Cascade	PatternShift	USD	7.0	1.0	7.0	0.0	4.5	NA	0.32	NA	NA	0.42	paypal	7.32	0.0	1.05	1.05	0.0	5.53	5.53	5.53	digital download	NA	https://patternshift.bandcamp.com/album/cascade	NA	197746 983930	NA	United States	US	NA
9/4/23 7:24 PM	payout	NA	NA	USD	NA	NA	NA	NA	NA	NA	NA	NA	NA	0.06	transfer	5.53	5.47	NA	NA	NA	-5.53	0.0	NA	NA	NA	NA	NA	NA	NA	NA	NA	0.0
